ì˙ït,éûä‘,çáåv,íjê´,èóê´,20ë„,30ë„,40ë„,50ë„,60ë„,70çŒà»è„,ãèèZé“,ãŒñ±é“,óàäXé“,ïΩãœíjê´,ïΩãœèóê´,ïΩãœ20ë„,ïΩãœ30ë„,ïΩãœ40ë„,ïΩãœ50ë„,ïΩãœ60ë„,ïΩãœ70çŒà»è„,ïΩãœãèèZé“,ïΩãœãŒñ±é“,ïΩãœóàäXé“
2024-10-01,5éû,0,0,0,0,0,0,0,0,0,0,0,0,0,0,0,0,0,0,0,0,0,0,0
2024-10-01,5éûîº,31,31,0,0,0,0,31,0,0,0,0,31,31,0,0,0,0,31,0,0,0,0,31
2024-10-01,6éû,61,61,0,0,0,0,61,0,0,0,0,61,61,0,0,0,0,61,0,0,0,0,61
2024-10-01,6éûîº,29,29,0,0,0,0,29,0,0,0,0,29,29,0,0,0,0,29,0,0,0,0,29
2024-10-01,7éû,46,46,0,0,0,0,0,0,46,0,46,0,46,0,0,0,0,0,0,46,0,46,0
2024-10-01,7éûîº,98,98,0,0,0,51,0,0,46,0,98,0,98,0,0,0,51,0,0,46,0,98,0
2024-10-01,8éû,139,139,0,0,0,108,31,0,0,0,51,87,139,0,0,0,108,31,0,0,0,51,87
2024-10-01,8éûîº,316,224,92,0,58,201,31,26,0,0,51,264,224,92,0,58,201,31,26,0,0,51,264
2024-10-01,9éû,285,193,92,0,58,201,0,26,0,0,51,233,193,92,0,58,201,0,26,0,0,51,233
2024-10-01,9éûîº,285,193,92,0,58,201,0,26,0,0,51,233,193,92,0,58,201,0,26,0,0,51,233
2024-10-01,10éû,135,135,0,0,0,108,0,26,0,0,51,83,135,0,0,0,108,0,26,0,0,51,83
2024-10-01,10éûîº,456,324,132,136,0,149,32,26,111,39,0,417,324,132,136,0,149,32,26,111,39,0,417
2024-10-01,11éû,546,344,202,0,58,287,103,26,71,39,51,455,344,202,0,58,287,103,26,71,39,51,455
2024-10-01,11éûîº,750,402,348,0,58,406,109,90,85,0,187,563,402,348,0,58,406,109,90,85,0,187,563
2024-10-01,12éû,991,343,648,0,90,534,159,121,85,0,341,650,343,648,0,90,534,159,121,85,0,341,650
2024-10-01,12éûîº,1162,484,678,292,90,324,160,210,85,136,302,724,484,678,292,90,324,160,210,85,136,302,724
2024-10-01,13éû,1353,459,894,292,334,222,171,248,85,136,450,767,459,894,292,334,222,171,248,85,136,450,767
2024-10-01,13éûîº,1435,379,1056,525,334,172,171,186,45,136,450,849,379,1056,525,334,172,171,186,45,136,450,849
2024-10-01,14éû,1450,273,1177,433,334,264,155,215,45,29,450,970,273,1177,433,334,264,155,215,45,29,450,970
2024-10-01,14éûîº,1564,342,1222,635,423,120,188,151,45,29,398,1136,342,1222,635,423,120,188,151,45,29,398,1136
2024-10-01,15éû,1416,390,1026,433,502,177,186,115,0,29,398,988,390,1026,433,502,177,186,115,0,29,398,988
2024-10-01,15éûîº,1415,330,1085,233,502,434,149,56,39,39,398,978,330,1085,233,502,434,149,56,39,39,398,978
2024-10-01,16éû,1705,500,1205,392,465,541,240,26,39,39,398,1267,500,1205,392,465,541,240,26,39,39,398,1267
2024-10-01,16éûîº,1598,534,1064,421,465,495,177,0,39,39,450,1109,534,1064,421,465,495,177,0,39,39,450,1109
2024-10-01,17éû,1884,533,1351,421,566,623,233,0,39,182,450,1251,533,1351,421,566,623,233,0,39,182,450,1251
2024-10-01,17éûîº,1597,380,1217,342,566,473,141,0,73,182,485,929,380,1217,342,566,473,141,0,73,182,485,929
2024-10-01,18éû,1288,474,814,159,566,344,146,0,73,182,485,621,474,814,159,566,344,146,0,73,182,485,621
2024-10-01,18éûîº,1432,478,954,360,465,344,126,37,99,143,384,905,478,954,360,465,344,126,37,99,143,384,905
2024-10-01,19éû,1200,298,902,360,322,452,0,0,65,184,384,631,298,902,360,322,452,0,0,65,184,384,631
2024-10-01,19éûîº,1773,534,1239,745,383,471,77,29,65,228,384,1161,534,1239,745,383,471,77,29,65,228,384,1161
2024-10-01,20éû,1815,728,1087,614,466,543,96,29,65,266,384,1164,728,1087,614,466,543,96,29,65,266,384,1164
2024-10-01,20éûîº,1570,700,870,463,466,543,67,29,0,266,384,919,700,870,463,466,543,67,29,0,266,384,919
2024-10-01,21éû,1345,532,813,463,294,451,136,0,0,61,384,899,532,813,463,294,451,136,0,0,61,384,899
2024-10-01,21éûîº,998,334,664,485,204,174,103,29,0,0,207,791,334,664,485,204,174,103,29,0,0,207,791
2024-10-01,22éû,841,384,457,485,61,110,146,37,0,0,0,841,384,457,485,61,110,146,37,0,0,0,841
2024-10-01,22éûîº,524,454,70,136,213,104,70,0,0,136,82,305,454,70,136,213,104,70,0,0,136,82,305
2024-10-01,23éû,215,181,34,0,131,50,34,0,0,0,0,216,181,34,0,131,50,34,0,0,0,0,216
2024-10-01,23éûîº,215,181,34,0,131,50,34,0,0,0,0,216,181,34,0,131,50,34,0,0,0,0,216
2024-10-01,24éû,227,193,34,0,131,61,34,0,0,61,0,165,193,34,0,131,61,34,0,0,61,0,165
2024-10-01,24éûîº,157,123,34,0,61,61,34,0,0,61,0,96,123,34,0,61,61,34,0,0,61,0,96
2024-10-01,25éû,275,132,143,70,204,0,0,0,0,143,0,132,132,143,70,204,0,0,0,0,143,0,132
2024-10-01,25éûîº,275,132,143,70,204,0,0,0,0,143,0,132,132,143,70,204,0,0,0,0,143,0,132
2024-10-01,26éû,275,132,143,70,204,0,0,0,0,143,0,132,132,143,70,204,0,0,0,0,143,0,132
2024-10-01,26éûîº,301,158,143,70,204,0,0,26,0,143,0,158,158,143,70,204,0,0,26,0,143,0,158
2024-10-01,27éû,275,132,143,70,204,0,0,0,0,143,0,132,132,143,70,204,0,0,0,0,143,0,132
2024-10-01,27éûîº,275,132,143,70,204,0,0,0,0,143,0,132,132,143,70,204,0,0,0,0,143,0,132
2024-10-01,28éû,275,132,143,70,204,0,0,0,0,143,0,132,132,143,70,204,0,0,0,0,143,0,132
2024-10-01,28éûîº,275,132,143,70,204,0,0,0,0,143,0,132,132,143,70,204,0,0,0,0,143,0,132
2024-10-02,5éû,70,70,0,70,0,0,0,0,0,0,0,70,70,0,70,0,0,0,0,0,0,0,70
2024-10-02,5éûîº,70,70,0,70,0,0,0,0,0,0,0,70,70,0,70,0,0,0,0,0,0,0,70
2024-10-02,6éû,70,70,0,70,0,0,0,0,0,0,0,70,70,0,70,0,0,0,0,0,0,0,70
2024-10-02,6éûîº,70,70,0,70,0,0,0,0,0,0,0,70,70,0,70,0,0,0,0,0,0,0,70
2024-10-02,7éû,70,70,0,70,0,0,0,0,0,0,0,70,70,0,70,0,0,0,0,0,0,0,70
2024-10-02,7éûîº,0,0,0,0,0,0,0,0,0,0,0,0,0,0,0,0,0,0,0,0,0,0,0
2024-10-02,8éû,152,51,101,0,101,51,0,0,0,0,153,0,51,101,0,101,51,0,0,0,0,153,0
2024-10-02,8éûîº,268,167,101,0,101,167,0,0,0,0,215,53,167,101,0,101,167,0,0,0,0,215,53
2024-10-02,9éû,152,51,101,0,101,51,0,0,0,0,153,0,51,101,0,101,51,0,0,0,0,153,0
2024-10-02,9éûîº,364,191,173,0,183,108,37,0,35,0,247,117,191,173,0,183,108,37,0,35,0,247,117
2024-10-02,10éû,450,312,138,0,183,108,97,27,33,0,247,203,312,138,0,183,108,97,27,33,0,247,203
2024-10-02,10éûîº,435,258,177,0,183,108,109,0,33,0,247,188,258,177,0,183,108,109,0,33,0,247,188
2024-10-02,11éû,620,311,309,0,251,108,109,94,56,0,247,373,311,309,0,251,108,109,94,56,0,247,373
2024-10-02,11éûîº,1550,657,893,484,334,378,141,115,96,39,373,1137,657,893,484,334,378,141,115,96,39,373,1137
2024-10-02,12éû,1520,482,1038,336,448,390,207,115,22,61,373,1085,482,1038,336,448,390,207,115,22,61,373,1085
2024-10-02,12éûîº,1355,313,1042,336,448,266,185,118,0,29,373,952,313,1042,336,448,266,185,118,0,29,373,952
2024-10-02,13éû,1294,454,840,336,464,287,146,59,0,29,334,931,454,840,336,464,287,146,59,0,29,334,931
2024-10-02,13éûîº,1015,568,447,142,320,331,177,43,0,0,334,682,568,447,142,320,331,177,43,0,0,334,682
2024-10-02,14éû,1866,720,1146,861,320,283,217,150,33,0,277,1589,720,1146,861,320,283,217,150,33,0,277,1589
2024-10-02,14éûîº,1544,562,982,605,305,273,175,150,33,92,225,1226,562,982,605,305,273,175,150,33,92,225,1226
2024-10-02,15éû,1390,583,807,445,154,487,137,132,33,92,239,1059,583,807,445,154,487,137,132,33,92,239,1059
2024-10-02,15éûîº,1150,280,870,500,101,288,130,96,33,0,239,910,280,870,500,101,288,130,96,33,0,239,910
2024-10-02,16éû,1297,272,1025,500,101,468,97,96,33,0,239,1058,272,1025,500,101,468,97,96,33,0,239,1058
2024-10-02,16éûîº,1483,387,1096,583,101,530,111,157,0,33,239,1210,387,1096,583,101,530,111,157,0,33,239,1210
2024-10-02,17éû,2016,659,1357,669,344,735,111,117,39,33,239,1743,659,1357,669,344,735,111,117,39,33,239,1743
2024-10-02,17éûîº,2438,829,1609,934,277,874,133,180,39,221,239,1978,829,1609,934,277,874,133,180,39,221,239,1978
2024-10-02,18éû,2436,843,1593,967,286,711,154,206,111,95,239,2101,843,1593,967,286,711,154,206,111,95,239,2101
2024-10-02,18éûîº,2059,1047,1012,579,446,547,290,85,111,0,86,1972,1047,1012,579,446,547,290,85,111,0,86,1972
2024-10-02,19éû,2184,1020,1164,466,487,721,312,85,111,216,86,1881,1020,1164,466,487,721,312,85,111,216,86,1881
2024-10-02,19éûîº,2120,1081,1039,201,487,721,465,133,111,260,86,1772,1081,1039,201,487,721,465,133,111,260,86,1772
2024-10-02,20éû,1940,1030,910,201,532,597,376,161,71,0,86,1854,1030,910,201,532,597,376,161,71,0,86,1854
2024-10-02,20éûîº,1615,914,701,201,367,406,373,194,71,33,86,1495,914,701,201,367,406,373,194,71,33,86,1495
2024-10-02,21éû,1503,991,512,201,367,391,325,146,71,33,86,1384,991,512,201,367,391,325,146,71,33,86,1384
2024-10-02,21éûîº,922,495,427,203,175,314,156,0,71,33,0,889,495,427,203,175,314,156,0,71,33,0,889
2024-10-02,22éû,776,231,545,203,175,362,35,0,0,0,0,776,231,545,203,175,362,35,0,0,0,0,776
2024-10-02,22éûîº,347,175,172,0,264,48,35,0,0,0,0,348,175,172,0,264,48,35,0,0,0,0,348
2024-10-02,23éû,136,88,48,0,88,48,0,0,0,0,0,137,88,48,0,88,48,0,0,0,0,0,137
2024-10-02,23éûîº,48,0,48,0,0,48,0,0,0,0,0,48,0,48,0,0,48,0,0,0,0,0,48
2024-10-02,24éû,65,65,0,0,0,0,35,29,0,29,0,35,65,0,0,0,0,35,29,0,29,0,35
2024-10-02,24éûîº,148,148,0,0,82,0,35,29,0,29,0,118,148,0,0,82,0,35,29,0,29,0,118
2024-10-02,25éû,148,148,0,0,82,0,35,29,0,29,0,118,148,0,0,82,0,35,29,0,29,0,118
2024-10-02,25éûîº,65,65,0,0,0,0,35,29,0,29,0,35,65,0,0,0,0,35,29,0,29,0,35
2024-10-02,26éû,93,93,0,0,0,0,63,29,0,29,0,63,93,0,0,0,0,63,29,0,29,0,63
2024-10-02,26éûîº,93,93,0,0,0,0,63,29,0,29,0,63,93,0,0,0,0,63,29,0,29,0,63
2024-10-02,27éû,65,65,0,0,0,0,35,29,0,29,0,35,65,0,0,0,0,35,29,0,29,0,35
2024-10-02,27éûîº,65,65,0,0,0,0,35,29,0,29,0,35,65,0,0,0,0,35,29,0,29,0,35
2024-10-02,28éû,65,65,0,0,0,0,35,29,0,29,0,35,65,0,0,0,0,35,29,0,29,0,35
2024-10-02,28éûîº,65,65,0,0,0,0,35,29,0,29,0,35,65,0,0,0,0,35,29,0,29,0,35
2024-10-03,5éû,0,0,0,0,0,0,0,0,0,0,0,0,0,0,0,0,0,0,0,0,0,0,0
2024-10-03,5éûîº,0,0,0,0,0,0,0,0,0,0,0,0,0,0,0,0,0,0,0,0,0,0,0
2024-10-03,6éû,0,0,0,0,0,0,0,0,0,0,0,0,0,0,0,0,0,0,0,0,0,0,0
2024-10-03,6éûîº,146,53,93,0,93,53,0,0,0,0,53,93,53,93,0,93,53,0,0,0,0,53,93
2024-10-03,7éû,146,53,93,0,93,53,0,0,0,0,53,93,53,93,0,93,53,0,0,0,0,53,93
2024-10-03,7éûîº,93,0,93,0,93,0,0,0,0,0,0,93,0,93,0,93,0,0,0,0,0,0,93
2024-10-03,8éû,31,31,0,0,0,0,31,0,0,0,0,31,31,0,0,0,0,31,0,0,0,0,31
2024-10-03,8éûîº,65,65,0,0,0,65,0,0,0,0,0,65,65,0,0,0,65,0,0,0,0,0,65
2024-10-03,9éû,160,68,92,0,68,92,0,0,0,92,68,0,68,92,0,68,92,0,0,0,92,68,0
2024-10-03,9éûîº,697,170,527,256,68,342,31,0,0,92,155,450,170,527,256,68,342,31,0,0,92,155,450
2024-10-03,10éû,832,223,609,256,166,250,57,102,0,92,155,585,223,609,256,166,250,57,102,0,92,155,585
2024-10-03,10éûîº,1019,268,751,426,109,372,0,76,33,126,155,737,268,751,426,109,372,0,76,33,126,155,737
2024-10-03,11éû,1971,402,1569,1006,109,675,70,76,33,95,193,1683,402,1569,1006,109,675,70,76,33,95,193,1683
2024-10-03,11éûîº,1903,316,1587,1006,109,622,37,0,128,95,193,1615,316,1587,1006,109,622,37,0,128,95,193,1615
2024-10-03,12éû,2009,408,1601,877,382,591,0,29,128,125,245,1639,408,1601,877,382,591,0,29,128,125,245,1639
2024-10-03,12éûîº,2176,371,1805,877,545,560,69,28,94,61,311,1802,371,1805,877,545,560,69,28,94,61,311,1802
2024-10-03,13éû,2028,353,1675,877,545,451,91,28,33,61,311,1655,353,1675,877,545,451,91,28,33,61,311,1655
2024-10-03,13éûîº,2197,335,1862,877,657,485,35,107,33,95,375,1726,335,1862,877,657,485,35,107,33,95,375,1726
2024-10-03,14éû,1932,407,1525,990,413,329,33,130,33,61,309,1560,407,1525,990,413,329,33,130,33,61,309,1560
2024-10-03,14éûîº,2003,407,1596,990,413,329,105,130,33,61,309,1632,407,1596,990,413,329,105,130,33,61,309,1632
2024-10-03,15éû,1474,291,1183,432,474,329,105,98,33,61,309,1103,291,1183,432,474,329,105,98,33,61,309,1103
2024-10-03,15éûîº,1537,355,1182,432,474,393,105,132,0,95,309,1133,355,1182,432,474,393,105,132,0,95,309,1133
2024-10-03,16éû,1707,476,1231,432,597,393,153,130,0,95,309,1303,476,1231,432,597,393,153,130,0,95,309,1303
2024-10-03,16éûîº,2021,669,1352,757,454,451,198,160,0,95,309,1616,669,1352,757,454,451,198,160,0,95,309,1616
2024-10-03,17éû,2449,985,1464,914,530,618,225,160,0,95,309,2044,985,1464,914,530,618,225,160,0,95,309,2044
2024-10-03,17éûîº,2425,920,1505,799,508,594,264,187,71,95,309,2021,920,1505,799,508,594,264,187,71,95,309,2021
2024-10-03,18éû,3394,1238,2156,1641,431,732,366,150,71,231,309,2853,1238,2156,1641,431,732,366,150,71,231,309,2853
2024-10-03,18éûîº,3687,1417,2270,1656,645,779,384,120,100,324,309,3054,1417,2270,1656,645,779,384,120,100,324,309,3054
2024-10-03,19éû,3469,1229,2240,1656,585,794,312,93,29,324,309,2836,1229,2240,1656,585,794,312,93,29,324,309,2836
2024-10-03,19éûîº,3215,1090,2125,1330,668,840,238,108,29,154,309,2751,1090,2125,1330,668,840,238,108,29,154,309,2751
2024-10-03,20éû,2590,843,1747,1183,585,491,240,89,0,91,245,2254,843,1747,1183,585,491,240,89,0,91,245,2254
2024-10-03,20éûîº,2424,977,1447,927,654,553,229,59,0,95,245,2083,977,1447,927,654,553,229,59,0,95,245,2083
2024-10-03,21éû,2293,873,1420,927,654,460,191,59,0,95,245,1953,873,1420,927,654,460,191,59,0,95,245,1953
2024-10-03,21éûîº,872,499,373,159,440,148,93,31,0,95,188,622,499,373,159,440,148,93,31,0,95,188,622
2024-10-03,22éû,752,466,286,159,440,61,59,31,0,95,101,589,466,286,159,440,61,59,31,0,95,101,589
2024-10-03,22éûîº,512,347,165,159,207,61,84,0,0,95,101,349,347,165,159,207,61,84,0,0,95,101,349
2024-10-03,23éû,295,130,165,0,207,61,26,0,0,61,68,165,130,165,0,207,61,26,0,0,61,68,165
2024-10-03,23éûîº,87,61,26,0,0,61,26,0,0,61,0,26,61,26,0,0,61,26,0,0,61,0,26
2024-10-03,24éû,293,61,232,0,232,61,0,0,0,205,0,89,61,232,0,232,61,0,0,0,205,0,89
2024-10-03,24éûîº,293,61,232,0,232,61,0,0,0,205,0,89,61,232,0,232,61,0,0,0,205,0,89
2024-10-03,25éû,293,61,232,0,232,61,0,0,0,205,0,89,61,232,0,232,61,0,0,0,205,0,89
2024-10-03,25éûîº,293,61,232,0,232,61,0,0,0,205,0,89,61,232,0,232,61,0,0,0,205,0,89
2024-10-03,26éû,293,61,232,0,232,61,0,0,0,205,0,89,61,232,0,232,61,0,0,0,205,0,89
2024-10-03,26éûîº,324,92,232,0,232,61,30,0,0,205,0,119,92,232,0,232,61,30,0,0,205,0,119
2024-10-03,27éû,293,61,232,0,232,61,0,0,0,205,0,89,61,232,0,232,61,0,0,0,205,0,89
2024-10-03,27éûîº,293,61,232,0,232,61,0,0,0,205,0,89,61,232,0,232,61,0,0,0,205,0,89
2024-10-03,28éû,293,61,232,0,232,61,0,0,0,205,0,89,61,232,0,232,61,0,0,0,205,0,89
2024-10-03,28éûîº,293,61,232,0,232,61,0,0,0,205,0,89,61,232,0,232,61,0,0,0,205,0,89
2024-10-04,5éû,441,178,263,78,232,129,0,0,0,205,0,236,178,263,78,232,129,0,0,0,205,0,236
2024-10-04,5éûîº,441,178,263,78,232,129,0,0,0,205,0,236,178,263,78,232,129,0,0,0,205,0,236
2024-10-04,6éû,298,178,120,78,89,129,0,0,0,61,0,236,178,120,78,89,129,0,0,0,61,0,236
2024-10-04,6éûîº,372,116,256,78,225,67,0,0,0,0,0,372,116,256,78,225,67,0,0,0,0,0,372
2024-10-04,7éû,146,116,30,78,0,67,0,0,0,0,0,146,116,30,78,0,67,0,0,0,0,0,146
2024-10-04,7éûîº,235,171,64,78,0,123,0,33,0,0,0,235,171,64,78,0,123,0,33,0,0,0,235
2024-10-04,8éû,202,116,86,78,55,67,0,0,0,0,0,202,116,86,78,55,67,0,0,0,0,0,202
2024-10-04,8éûîº,377,239,138,78,178,119,0,0,0,0,0,377,239,138,78,178,119,0,0,0,0,0,377
2024-10-04,9éû,570,363,207,78,247,119,124,0,0,0,106,464,363,207,78,247,119,124,0,0,0,106,464
2024-10-04,9éûîº,571,364,207,78,247,119,93,32,0,0,106,465,364,207,78,247,119,93,32,0,0,106,465
2024-10-04,10éû,741,442,299,78,247,322,93,0,0,92,106,543,442,299,78,247,322,93,0,0,92,106,543
2024-10-04,10éûîº,707,319,388,78,124,322,181,0,0,92,106,509,319,388,78,124,322,181,0,0,92,106,509
2024-10-04,11éû,693,382,311,78,124,193,297,0,0,0,106,587,382,311,78,124,193,297,0,0,0,106,587
2024-10-04,11éûîº,1459,505,954,597,390,193,246,32,0,0,249,1210,505,954,597,390,193,246,32,0,0,249,1210
2024-10-04,12éû,1440,584,856,335,390,230,419,65,0,0,286,1154,584,856,335,390,230,419,65,0,0,286,1154
2024-10-04,12éûîº,1496,586,910,335,247,274,540,99,0,0,143,1353,586,910,335,247,274,540,99,0,0,143,1353
2024-10-04,13éû,1956,585,1371,590,475,301,396,194,0,0,290,1666,585,1371,590,475,301,396,194,0,0,290,1666
2024-10-04,13éûîº,2153,635,1518,590,475,350,418,269,50,0,290,1864,635,1518,590,475,350,418,269,50,0,290,1864
2024-10-04,14éû,1935,545,1390,590,353,171,466,302,50,0,260,1675,545,1390,590,353,171,466,302,50,0,260,1675
2024-10-04,14éûîº,1807,569,1238,446,428,115,428,337,50,0,222,1585,569,1238,446,428,115,428,337,50,0,222,1585
2024-10-04,15éû,1753,761,992,605,428,121,323,274,0,0,222,1531,761,992,605,428,121,323,274,0,0,222,1531
2024-10-04,15éûîº,1965,700,1265,605,498,348,170,309,33,33,222,1710,700,1265,605,498,348,170,309,33,33,222,1710
2024-10-04,16éû,2026,728,1298,350,674,430,169,367,33,33,222,1770,728,1298,350,674,430,169,367,33,33,222,1770
2024-10-04,16éûîº,1771,623,1148,496,420,321,148,333,50,0,222,1549,623,1148,496,420,321,148,333,50,0,222,1549
2024-10-04,17éû,1957,614,1343,384,517,456,215,334,50,0,222,1735,614,1343,384,517,456,215,334,50,0,222,1735
2024-10-04,17éûîº,2778,830,1948,530,669,708,394,392,84,74,357,2347,830,1948,530,669,708,394,392,84,74,357,2347
2024-10-04,18éû,2931,815,2116,384,819,735,365,427,200,112,357,2462,815,2116,384,819,735,365,427,200,112,357,2462
2024-10-04,18éûîº,2743,894,1849,404,725,890,345,212,166,249,419,2075,894,1849,404,725,890,345,212,166,249,419,2075
2024-10-04,19éû,2959,1180,1779,541,807,1014,358,122,115,462,419,2078,1180,1779,541,807,1014,358,122,115,462,419,2078
2024-10-04,19éûîº,2597,1103,1494,541,598,1002,268,122,65,370,419,1808,1103,1494,541,598,1002,268,122,65,370,419,1808
2024-10-04,20éû,2434,985,1449,541,598,950,157,122,65,263,419,1752,985,1449,541,598,950,157,122,65,263,419,1752
2024-10-04,20éûîº,2331,932,1399,408,598,951,185,122,65,263,419,1648,932,1399,408,598,951,185,122,65,263,419,1648
2024-10-04,21éû,2057,764,1293,408,515,759,186,122,65,180,284,1592,764,1293,408,515,759,186,122,65,180,284,1592
2024-10-04,21éûîº,2357,883,1474,521,656,704,288,122,65,180,337,1838,883,1474,521,656,704,288,122,65,180,337,1838
2024-10-04,22éû,1556,745,811,408,503,397,155,27,65,180,194,1182,745,811,408,503,397,155,27,65,180,194,1182
2024-10-04,22éûîº,896,190,706,0,419,335,76,0,65,44,194,657,190,706,0,419,335,76,0,65,44,194,657
2024-10-04,23éû,509,130,379,0,188,211,44,0,65,44,130,334,130,379,0,188,211,44,0,65,44,130,334
2024-10-04,23éûîº,496,99,397,0,191,195,44,0,65,44,61,390,99,397,0,191,195,44,0,65,44,61,390
2024-10-04,24éû,239,37,202,0,71,133,0,34,0,0,0,239,37,202,0,71,133,0,34,0,0,0,239
2024-10-04,24éûîº,375,173,202,136,71,133,0,34,0,0,0,376,173,202,136,71,133,0,34,0,0,0,376
2024-10-04,25éû,174,37,137,0,71,67,0,34,0,0,0,174,37,137,0,71,67,0,34,0,0,0,174
2024-10-04,25éûîº,139,37,102,0,71,67,0,0,0,0,0,139,37,102,0,71,67,0,0,0,0,0,139
2024-10-04,26éû,67,37,30,0,0,67,0,0,0,0,0,67,37,30,0,0,67,0,0,0,0,0,67
2024-10-04,26éûîº,203,173,30,136,0,67,0,0,0,0,0,204,173,30,136,0,67,0,0,0,0,0,204
2024-10-04,27éû,67,37,30,0,0,67,0,0,0,0,0,67,37,30,0,0,67,0,0,0,0,0,67
2024-10-04,27éûîº,67,37,30,0,0,67,0,0,0,0,0,67,37,30,0,0,67,0,0,0,0,0,67
2024-10-04,28éû,67,37,30,0,0,67,0,0,0,0,0,67,37,30,0,0,67,0,0,0,0,0,67
2024-10-04,28éûîº,67,37,30,0,0,67,0,0,0,0,0,67,37,30,0,0,67,0,0,0,0,0,67
2024-10-05,5éû,0,0,0,0,0,0,0,0,0,0,0,0,0,0,0,0,0,0,0,0,0,0,0
2024-10-05,5éûîº,0,0,0,0,0,0,0,0,0,0,0,0,0,0,0,0,0,0,0,0,0,0,0
2024-10-05,6éû,146,146,0,0,74,72,0,0,0,0,0,146,146,0,0,74,72,0,0,0,0,0,146
2024-10-05,6éûîº,189,189,0,0,65,124,0,0,0,0,51,137,189,0,0,65,124,0,0,0,0,51,137
2024-10-05,7éû,208,153,55,0,55,124,0,29,0,29,51,127,153,55,0,55,124,0,29,0,29,51,127
2024-10-05,7éûîº,212,117,95,0,55,51,40,30,35,0,51,161,117,95,0,55,51,40,30,35,0,51,161
2024-10-05,8éû,427,87,340,0,300,51,40,0,35,143,153,131,87,340,0,300,51,40,0,35,143,153,131
2024-10-05,8éûîº,489,149,340,0,362,51,40,0,35,143,215,131,149,340,0,362,51,40,0,35,143,215,131
2024-10-05,9éû,458,87,371,0,300,51,71,0,35,143,153,162,87,371,0,300,51,71,0,35,143,153,162
2024-10-05,9éûîº,647,183,464,131,300,144,71,0,0,235,153,258,183,464,131,300,144,71,0,0,235,153,258
2024-10-05,10éû,1065,243,822,131,465,231,133,64,39,305,239,520,243,822,131,465,231,133,64,39,305,239,520
2024-10-05,10éûîº,1873,534,1339,613,557,373,236,94,0,265,239,1369,534,1339,613,557,373,236,94,0,265,239,1369
2024-10-05,11éû,2209,711,1498,393,787,403,432,128,65,176,329,1703,711,1498,393,787,403,432,128,65,176,329,1703
2024-10-05,11éûîº,2668,887,1781,387,1125,617,427,71,39,143,539,1985,887,1781,387,1125,617,427,71,39,143,539,1985
2024-10-05,12éû,2501,796,1705,387,946,530,464,133,39,29,429,2042,796,1705,387,946,530,464,133,39,29,429,2042
2024-10-05,12éûîº,2635,761,1874,387,853,605,569,181,39,155,429,2051,761,1874,387,853,605,569,181,39,155,429,2051
2024-10-05,13éû,2690,721,1969,387,796,773,442,251,39,155,393,2141,721,1969,387,796,773,442,251,39,155,393,2141
2024-10-05,13éûîº,2606,655,1951,387,855,704,367,253,39,122,393,2091,655,1951,387,855,704,367,253,39,122,393,2091
2024-10-05,14éû,2440,560,1880,256,827,780,340,155,79,61,292,2085,560,1880,256,827,780,340,155,79,61,292,2085
2024-10-05,14éûîº,2991,695,2296,563,1058,824,371,133,41,0,393,2597,695,2296,563,1058,824,371,133,41,0,393,2597
2024-10-05,15éû,3580,937,2643,823,1042,923,522,226,41,0,455,3124,937,2643,823,1042,923,522,226,41,0,455,3124
2024-10-05,15éûîº,4184,1162,3022,1100,1292,852,493,258,188,92,393,3699,1162,3022,1100,1292,852,493,258,188,92,393,3699
2024-10-05,16éû,4611,1276,3335,1264,1356,850,619,333,188,92,393,4125,1276,3335,1264,1356,850,619,333,188,92,393,4125
2024-10-05,16éûîº,4625,809,3816,1158,1336,850,743,348,188,92,486,4140,809,3816,1158,1336,850,743,348,188,92,486,4140
2024-10-05,17éû,4950,737,4213,1286,1469,742,887,418,146,92,486,4463,737,4213,1286,1469,742,887,418,146,92,486,4463
2024-10-05,17éûîº,5029,872,4157,1650,1446,803,633,349,146,92,434,4595,872,4157,1650,1446,803,633,349,146,92,434,4595
2024-10-05,18éû,4395,620,3775,1505,1414,543,506,322,104,0,342,4054,620,3775,1505,1414,543,506,322,104,0,342,4054
2024-10-05,18éûîº,4236,430,3806,1505,1451,443,467,263,104,0,342,3894,430,3806,1505,1451,443,467,263,104,0,342,3894
2024-10-05,19éû,3916,498,3418,1329,1281,539,430,230,104,29,240,3646,498,3418,1329,1281,539,430,230,104,29,240,3646
2024-10-05,19éûîº,3889,468,3421,1329,1260,576,387,230,104,122,240,3527,468,3421,1329,1260,576,387,230,104,122,240,3527
2024-10-05,20éû,4250,501,3749,1473,1220,763,425,259,107,92,240,3917,501,3749,1473,1220,763,425,259,107,92,240,3917
2024-10-05,20éûîº,3565,480,3085,1224,1179,514,355,250,42,92,150,3323,480,3085,1224,1179,514,355,250,42,92,150,3323
2024-10-05,21éû,2408,498,1910,823,783,310,373,118,0,0,63,2345,498,1910,823,783,310,373,118,0,0,63,2345
2024-10-05,21éûîº,2254,501,1753,947,630,310,299,66,0,0,63,2190,501,1753,947,630,310,299,66,0,0,63,2190
2024-10-05,22éû,1934,356,1578,802,487,310,266,66,0,0,63,1870,356,1578,802,487,310,266,66,0,0,63,1870
2024-10-05,22éûîº,1052,183,869,256,298,260,171,66,0,0,63,988,183,869,256,298,260,171,66,0,0,63,988
2024-10-05,23éû,632,125,507,256,174,129,73,0,0,0,0,633,125,507,256,174,129,73,0,0,0,0,633
2024-10-05,23éûîº,546,125,421,256,88,129,73,0,0,0,0,547,125,421,256,88,129,73,0,0,0,0,547
2024-10-05,24éû,475,99,376,256,0,191,0,27,0,61,0,413,99,376,256,0,191,0,27,0,61,0,413
2024-10-05,24éûîº,219,99,120,0,0,191,0,27,0,61,0,157,99,120,0,0,191,0,27,0,61,0,157
2024-10-05,25éû,219,99,120,0,0,191,0,27,0,61,0,157,99,120,0,0,191,0,27,0,61,0,157
2024-10-05,25éûîº,219,99,120,0,0,191,0,27,0,61,0,157,99,120,0,0,191,0,27,0,61,0,157
2024-10-05,26éû,219,99,120,0,0,191,0,27,0,61,0,157,99,120,0,0,191,0,27,0,61,0,157
2024-10-05,26éûîº,219,99,120,0,0,191,0,27,0,61,0,157,99,120,0,0,191,0,27,0,61,0,157
2024-10-05,27éû,219,99,120,0,0,191,0,27,0,61,0,157,99,120,0,0,191,0,27,0,61,0,157
2024-10-05,27éûîº,219,99,120,0,0,191,0,27,0,61,0,157,99,120,0,0,191,0,27,0,61,0,157
2024-10-05,28éû,219,99,120,0,0,191,0,27,0,61,0,157,99,120,0,0,191,0,27,0,61,0,157
2024-10-05,28éûîº,219,99,120,0,0,191,0,27,0,61,0,157,99,120,0,0,191,0,27,0,61,0,157
2024-10-06,5éû,219,99,120,0,0,191,0,27,0,61,0,157,99,120,0,0,191,0,27,0,61,0,157
2024-10-06,5éûîº,219,99,120,0,0,191,0,27,0,61,0,157,99,120,0,0,191,0,27,0,61,0,157
2024-10-06,6éû,219,99,120,0,0,191,0,27,0,61,0,157,99,120,0,0,191,0,27,0,61,0,157
2024-10-06,6éûîº,219,99,120,0,0,191,0,27,0,61,0,157,99,120,0,0,191,0,27,0,61,0,157
2024-10-06,7éû,325,150,175,0,55,243,0,27,0,61,51,212,150,175,0,55,243,0,27,0,61,51,212
2024-10-06,7éûîº,325,150,175,0,55,243,0,27,0,61,51,212,150,175,0,55,243,0,27,0,61,51,212
2024-10-06,8éû,574,268,306,0,201,305,40,27,0,123,141,308,268,306,0,201,305,40,27,0,123,141,308
2024-10-06,8éûîº,600,263,337,87,145,268,71,27,0,123,141,334,263,337,87,145,268,71,27,0,123,141,334
2024-10-06,9éû,637,262,375,87,145,268,109,27,0,61,179,396,262,375,87,145,268,109,27,0,61,179,396
2024-10-06,9éûîº,1133,449,684,468,145,354,137,27,0,61,266,805,449,684,468,145,354,137,27,0,61,266,805
2024-10-06,10éû,1580,721,859,468,266,645,199,0,0,61,300,1217,721,859,468,266,645,199,0,0,61,300,1217
2024-10-06,10éûîº,1934,808,1126,468,348,826,239,51,0,61,300,1571,808,1126,468,348,826,239,51,0,61,300,1571
2024-10-06,11éû,2402,640,1762,709,561,708,254,168,0,95,249,2058,640,1762,709,561,708,254,168,0,95,249,2058
2024-10-06,11éûîº,2616,824,1792,832,552,708,293,198,30,95,249,2273,824,1792,832,552,708,293,198,30,95,249,2273
2024-10-06,12éû,3339,1067,2272,952,580,1016,444,298,48,61,249,3029,1067,2272,952,580,1016,444,298,48,61,249,3029
2024-10-06,12éûîº,3882,1331,2551,959,909,1180,444,340,48,61,300,3519,1331,2551,959,909,1180,444,340,48,61,300,3519
2024-10-06,13éû,3816,1181,2635,824,1010,1085,451,397,48,91,300,3424,1181,2635,824,1010,1085,451,397,48,91,300,3424
2024-10-06,13éûîº,4659,1422,3237,824,1352,1266,599,569,48,121,402,4136,1422,3237,824,1352,1266,599,569,48,121,402,4136
2024-10-06,14éû,4730,1309,3421,577,1776,975,726,627,48,121,402,4208,1309,3421,577,1776,975,726,627,48,121,402,4208
2024-10-06,14éûîº,4932,1243,3689,912,1907,911,666,486,48,91,402,4439,1243,3689,912,1907,911,666,486,48,91,402,4439
2024-10-06,15éû,4966,1939,3027,511,2062,1185,620,504,82,91,364,4511,1939,3027,511,2062,1185,620,504,82,91,364,4511
2024-10-06,15éûîº,5063,2196,2867,511,2218,1093,595,562,82,187,364,4511,2196,2867,511,2218,1093,595,562,82,187,364,4511
2024-10-06,16éû,5759,2524,3235,828,2202,1413,619,498,197,91,364,5303,2524,3235,828,2202,1413,619,498,197,91,364,5303
2024-10-06,16éûîº,5826,2635,3191,950,2031,1608,609,506,120,164,364,5297,2635,3191,950,2031,1608,609,506,120,164,364,5297
2024-10-06,17éû,6346,2590,3756,1454,2005,1620,593,553,120,164,364,5817,2590,3756,1454,2005,1620,593,553,120,164,364,5817
2024-10-06,17éûîº,4703,1984,2719,1471,1367,1117,419,293,33,125,364,4214,1984,2719,1471,1367,1117,419,293,33,125,364,4214
2024-10-06,18éû,2960,1366,1594,813,862,934,257,93,0,125,263,2572,1366,1594,813,862,934,257,93,0,125,263,2572
2024-10-06,18éûîº,2477,1052,1425,495,1130,621,136,93,0,268,121,2088,1052,1425,495,1130,621,136,93,0,268,121,2088
2024-10-06,19éû,2435,913,1522,495,1145,500,136,157,0,269,86,2079,913,1522,495,1145,500,136,157,0,269,86,2079
2024-10-06,19éûîº,2301,822,1479,495,1189,463,58,93,0,206,86,2007,822,1479,495,1189,463,58,93,0,206,86,2007
2024-10-06,20éû,1816,776,1040,632,779,258,86,60,0,309,86,1420,776,1040,632,779,258,86,60,0,309,86,1420
2024-10-06,20éûîº,2097,989,1108,762,907,258,86,83,0,309,86,1701,989,1108,762,907,258,86,83,0,309,86,1701
2024-10-06,21éû,1730,802,928,603,815,187,64,60,0,309,0,1421,802,928,603,815,187,64,60,0,309,0,1421
2024-10-06,21éûîº,852,408,444,371,141,249,27,63,0,228,0,624,408,444,371,141,249,27,63,0,228,0,624
2024-10-06,22éû,622,301,321,371,51,143,27,29,0,166,0,456,301,321,371,51,143,27,29,0,166,0,456
2024-10-06,22éûîº,299,109,190,103,51,86,27,29,0,29,0,269,109,190,103,51,86,27,29,0,29,0,269
2024-10-06,23éû,299,109,190,103,51,86,27,29,0,29,0,269,109,190,103,51,86,27,29,0,29,0,269
2024-10-06,23éûîº,269,79,190,103,51,86,27,0,0,0,0,269,79,190,103,51,86,27,0,0,0,0,269
2024-10-06,24éû,27,27,0,0,0,0,27,0,0,0,0,27,27,0,0,0,0,27,0,0,0,0,27
2024-10-06,24éûîº,57,57,0,0,0,0,27,29,0,0,0,57,57,0,0,0,0,27,29,0,0,0,57
2024-10-06,25éû,27,27,0,0,0,0,27,0,0,0,0,27,27,0,0,0,0,27,0,0,0,0,27
2024-10-06,25éûîº,27,27,0,0,0,0,27,0,0,0,0,27,27,0,0,0,0,27,0,0,0,0,27
2024-10-06,26éû,27,27,0,0,0,0,27,0,0,0,0,27,27,0,0,0,0,27,0,0,0,0,27
2024-10-06,26éûîº,27,27,0,0,0,0,27,0,0,0,0,27,27,0,0,0,0,27,0,0,0,0,27
2024-10-06,27éû,27,27,0,0,0,0,27,0,0,0,0,27,27,0,0,0,0,27,0,0,0,0,27
2024-10-06,27éûîº,27,27,0,0,0,0,27,0,0,0,0,27,27,0,0,0,0,27,0,0,0,0,27
2024-10-06,28éû,27,27,0,0,0,0,27,0,0,0,0,27,27,0,0,0,0,27,0,0,0,0,27
2024-10-06,28éûîº,27,27,0,0,0,0,27,0,0,0,0,27,27,0,0,0,0,27,0,0,0,0,27
2024-10-07,5éû,24,24,0,0,0,0,24,0,0,0,0,24,24,0,0,0,0,24,0,0,0,0,24
2024-10-07,5éûîº,24,24,0,0,0,0,24,0,0,0,0,24,24,0,0,0,0,24,0,0,0,0,24
2024-10-07,6éû,27,27,0,0,0,0,0,27,0,0,0,27,27,0,0,0,0,0,27,0,0,0,27
2024-10-07,6éûîº,112,56,56,0,56,0,0,56,0,0,29,83,56,56,0,56,0,0,56,0,0,29,83
2024-10-07,7éû,0,0,0,0,0,0,0,0,0,0,0,0,0,0,0,0,0,0,0,0,0,0,0
2024-10-07,7éûîº,0,0,0,0,0,0,0,0,0,0,0,0,0,0,0,0,0,0,0,0,0,0,0
2024-10-07,8éû,314,136,178,0,178,105,30,0,0,0,51,262,136,178,0,178,105,30,0,0,0,51,262
2024-10-07,8éûîº,314,136,178,0,178,105,30,0,0,0,51,262,136,178,0,178,105,30,0,0,0,51,262
2024-10-07,9éû,416,108,308,0,178,144,68,25,0,0,89,327,108,308,0,178,144,68,25,0,0,89,327
2024-10-07,9éûîº,585,190,395,0,178,277,104,25,0,0,176,409,190,395,0,178,277,104,25,0,0,176,409
2024-10-07,10éû,665,237,428,0,178,277,104,59,46,0,176,489,237,428,0,178,277,104,59,46,0,176,489
2024-10-07,10éûîº,962,311,651,256,178,352,104,25,46,61,124,776,311,651,256,178,352,104,25,46,61,124,776
2024-10-07,11éû,951,300,651,256,254,290,104,0,46,0,124,827,300,651,256,254,290,104,0,46,0,124,827
2024-10-07,11éûîº,1279,243,1036,256,560,231,130,59,41,29,349,900,243,1036,256,560,231,130,59,41,29,349,900
2024-10-07,12éû,1694,356,1338,558,560,281,130,121,41,59,349,1285,356,1338,558,560,281,130,121,41,59,349,1285
2024-10-07,12éûîº,1767,429,1338,558,560,281,130,120,117,202,237,1327,429,1338,558,560,281,130,120,117,202,237,1327
2024-10-07,13éû,1546,331,1215,558,340,347,125,0,175,0,124,1423,331,1215,558,340,347,125,0,175,0,124,1423
2024-10-07,13éûîº,1536,280,1256,558,380,241,217,0,138,0,124,1412,280,1256,558,380,241,217,0,138,0,124,1412
2024-10-07,14éû,1382,235,1147,558,359,179,147,0,138,0,86,1296,235,1147,558,359,179,147,0,138,0,86,1296
2024-10-07,14éûîº,1684,275,1409,558,542,271,187,29,96,92,86,1506,275,1409,558,542,271,187,29,96,92,86,1506
2024-10-07,15éû,1242,269,973,302,491,286,94,29,38,92,86,1063,269,973,302,491,286,94,29,38,92,86,1063
2024-10-07,15éûîº,1018,269,749,302,360,195,93,29,38,0,86,933,269,749,302,360,195,93,29,38,0,86,933
2024-10-07,16éû,1087,245,842,302,429,236,53,28,38,0,86,1001,245,842,302,429,236,53,28,38,0,86,1001
2024-10-07,16éûîº,1070,206,864,302,360,293,75,0,38,0,138,931,206,864,302,360,293,75,0,38,0,138,931
2024-10-07,17éû,1237,239,998,302,360,385,45,29,114,0,138,1099,239,998,302,360,385,45,29,114,0,138,1099
2024-10-07,17éûîº,1178,272,906,302,360,241,81,44,148,0,86,1091,272,906,302,360,241,81,44,148,0,86,1091
2024-10-07,18éû,1369,327,1042,411,360,271,92,123,109,122,86,1161,327,1042,411,360,271,92,123,109,122,86,1161
2024-10-07,18éûîº,756,292,464,411,0,148,92,62,41,29,86,640,292,464,411,0,148,92,62,41,29,86,640
2024-10-07,19éû,806,358,448,411,0,243,59,91,0,29,86,689,358,448,411,0,243,59,91,0,29,86,689
2024-10-07,19éûîº,961,513,448,411,221,207,59,62,0,0,169,792,513,448,411,221,207,59,62,0,0,169,792
2024-10-07,20éû,849,401,448,411,256,145,35,0,0,0,169,679,401,448,411,256,145,35,0,0,0,169,679
2024-10-07,20éûîº,592,203,389,302,173,86,30,0,0,0,86,506,203,389,302,173,86,30,0,0,0,86,506
2024-10-07,21éû,423,121,302,302,90,0,30,0,0,0,0,423,121,302,302,90,0,30,0,0,0,0,423
2024-10-07,21éûîº,397,95,302,302,68,0,26,0,0,0,0,397,95,302,302,68,0,26,0,0,0,0,397
2024-10-07,22éû,453,151,302,385,68,0,0,0,0,0,0,453,151,302,385,68,0,0,0,0,0,0,453
2024-10-07,22éûîº,339,339,0,219,68,51,0,0,0,136,0,203,339,0,219,68,51,0,0,0,136,0,203
2024-10-07,23éû,203,203,0,82,68,51,0,0,0,0,0,203,203,0,82,68,51,0,0,0,0,0,203
2024-10-07,23éûîº,134,134,0,82,0,51,0,0,0,0,0,134,134,0,82,0,51,0,0,0,0,0,134
2024-10-07,24éû,134,134,0,82,0,51,0,0,0,0,0,134,134,0,82,0,51,0,0,0,0,0,134
2024-10-07,24éûîº,51,51,0,0,0,51,0,0,0,0,0,51,51,0,0,0,51,0,0,0,0,0,51
2024-10-07,25éû,96,96,0,0,0,96,0,0,0,0,0,96,96,0,0,0,96,0,0,0,0,0,96
2024-10-07,25éûîº,51,51,0,0,0,51,0,0,0,0,0,51,51,0,0,0,51,0,0,0,0,0,51
2024-10-07,26éû,51,51,0,0,0,51,0,0,0,0,0,51,51,0,0,0,51,0,0,0,0,0,51
2024-10-07,26éûîº,51,51,0,0,0,51,0,0,0,0,0,51,51,0,0,0,51,0,0,0,0,0,51
2024-10-07,27éû,51,51,0,0,0,51,0,0,0,0,0,51,51,0,0,0,51,0,0,0,0,0,51
2024-10-07,27éûîº,51,51,0,0,0,51,0,0,0,0,0,51,51,0,0,0,51,0,0,0,0,0,51
2024-10-07,28éû,51,51,0,0,0,51,0,0,0,0,0,51,51,0,0,0,51,0,0,0,0,0,51
2024-10-07,28éûîº,51,51,0,0,0,51,0,0,0,0,0,51,51,0,0,0,51,0,0,0,0,0,51
2024-10-08,5éû,51,51,0,0,0,51,0,0,0,0,0,51,51,0,0,0,51,0,0,0,0,0,51
2024-10-08,5éûîº,51,51,0,0,0,51,0,0,0,0,0,51,51,0,0,0,51,0,0,0,0,0,51
2024-10-08,6éû,101,101,0,0,49,51,0,0,0,0,0,101,101,0,0,49,51,0,0,0,0,0,101
2024-10-08,6éûîº,38,38,0,0,0,0,38,0,0,0,0,38,38,0,0,0,0,38,0,0,0,0,38
2024-10-08,7éû,51,51,0,0,0,51,0,0,0,0,51,0,51,0,0,0,51,0,0,0,0,51,0
2024-10-08,7éûîº,51,51,0,0,0,51,0,0,0,0,51,0,51,0,0,0,51,0,0,0,0,51,0
2024-10-08,8éû,234,133,101,0,101,96,0,0,37,0,153,82,133,101,0,101,96,0,0,37,0,153,82
2024-10-08,8éûîº,392,113,279,0,279,113,0,0,0,61,153,178,113,279,0,279,113,0,0,0,61,153,178
2024-10-08,9éû,311,0,311,0,279,0,0,32,0,0,101,210,0,311,0,279,0,0,32,0,0,101,210
2024-10-08,9éûîº,311,0,311,0,279,0,0,32,0,0,101,210,0,311,0,279,0,0,32,0,0,101,210
2024-10-08,10éû,407,0,407,0,279,88,0,0,39,39,101,266,0,407,0,279,88,0,0,39,39,101,266
2024-10-08,10éûîº,570,32,538,0,457,0,32,0,81,39,101,431,32,538,0,457,0,32,0,81,39,101,431
2024-10-08,11éû,632,133,499,0,457,51,32,49,41,0,153,480,133,499,0,457,51,32,49,41,0,153,480
2024-10-08,11éûîº,962,227,735,0,654,144,36,49,77,0,296,666,227,735,0,654,144,36,49,77,0,296,666
2024-10-08,12éû,1132,358,774,0,724,206,36,49,117,61,296,775,358,774,0,724,206,36,49,117,61,296,775
2024-10-08,12éûîº,1404,505,899,0,793,256,112,53,188,61,326,1016,505,899,0,793,256,112,53,188,61,326,1016
2024-10-08,13éû,1171,494,677,0,437,258,207,80,188,0,390,782,494,677,0,437,258,207,80,188,0,390,782
2024-10-08,13éûîº,1079,382,697,0,527,230,187,23,111,0,360,719,382,697,0,527,230,187,23,111,0,360,719
2024-10-08,14éû,903,307,596,0,372,179,187,53,111,29,259,615,307,596,0,372,179,187,53,111,29,259,615
2024-10-08,14éûîº,1068,368,700,0,472,177,221,86,111,29,360,679,368,700,0,472,177,221,86,111,29,360,679
2024-10-08,15éû,1417,555,862,159,650,235,204,57,111,0,450,966,555,862,159,650,235,204,57,111,0,450,966
2024-10-08,15éûîº,1429,554,875,159,649,311,174,23,111,0,450,979,554,875,159,649,311,174,23,111,0,450,979
2024-10-08,16éû,1441,510,931,159,649,341,138,41,111,92,450,899,510,931,159,649,341,138,41,111,92,450,899
2024-10-08,16éûîº,1324,393,931,159,581,284,113,74,111,92,450,781,393,931,159,581,284,113,74,111,92,450,781
2024-10-08,17éû,1461,448,1013,159,671,332,113,74,111,0,450,1011,448,1013,159,671,332,113,74,111,0,450,1011
2024-10-08,17éûîº,1857,460,1397,303,671,413,158,166,145,0,398,1459,460,1397,303,671,413,158,166,145,0,398,1459
2024-10-08,18éû,1796,350,1446,303,643,542,106,55,145,0,297,1499,350,1446,303,643,542,106,55,145,0,297,1499
2024-10-08,18éûîº,1914,417,1497,439,718,450,106,55,145,143,297,1474,417,1497,439,718,450,106,55,145,143,297,1474
2024-10-08,19éû,1841,414,1427,439,857,357,93,55,39,143,297,1401,414,1427,439,857,357,93,55,39,143,297,1401
2024-10-08,19éûîº,1756,216,1540,536,713,357,53,55,39,0,297,1459,216,1540,536,713,357,53,55,39,0,297,1459
2024-10-08,20éû,1834,309,1525,536,713,371,87,85,39,29,297,1507,309,1525,536,713,371,87,85,39,29,297,1507
2024-10-08,20éûîº,1842,353,1489,536,713,304,167,56,64,0,297,1545,353,1489,536,713,304,167,56,64,0,297,1545
2024-10-08,21éû,1316,203,1113,400,462,259,169,26,0,0,297,1020,203,1113,400,462,259,169,26,0,0,297,1020
2024-10-08,21éûîº,929,139,790,400,282,152,68,26,0,0,207,723,139,790,400,282,152,68,26,0,0,207,723
2024-10-08,22éû,715,113,602,400,138,152,24,0,0,0,63,652,113,602,400,138,152,24,0,0,0,63,652
2024-10-08,22éûîº,690,88,602,400,138,152,0,0,0,0,63,627,88,602,400,138,152,0,0,0,0,63,627
2024-10-08,23éû,688,150,538,400,138,150,0,0,0,61,0,627,150,538,400,138,150,0,0,0,61,0,627
2024-10-08,23éûîº,349,49,300,256,0,49,44,0,0,44,0,305,49,300,256,0,49,44,0,0,44,0,305
2024-10-08,24éû,93,49,44,0,0,49,44,0,0,44,0,49,49,44,0,0,49,44,0,0,44,0,49
2024-10-08,24éûîº,93,49,44,0,0,49,44,0,0,44,0,49,49,44,0,0,49,44,0,0,44,0,49
2024-10-08,25éû,93,49,44,0,0,49,44,0,0,44,0,49,49,44,0,0,49,44,0,0,44,0,49
2024-10-08,25éûîº,93,49,44,0,0,49,44,0,0,44,0,49,49,44,0,0,49,44,0,0,44,0,49
2024-10-08,26éû,93,49,44,0,0,49,44,0,0,44,0,49,49,44,0,0,49,44,0,0,44,0,49
2024-10-08,26éûîº,93,49,44,0,0,49,44,0,0,44,0,49,49,44,0,0,49,44,0,0,44,0,49
2024-10-08,27éû,93,49,44,0,0,49,44,0,0,44,0,49,49,44,0,0,49,44,0,0,44,0,49
2024-10-08,27éûîº,93,49,44,0,0,49,44,0,0,44,0,49,49,44,0,0,49,44,0,0,44,0,49
2024-10-08,28éû,93,49,44,0,0,49,44,0,0,44,0,49,49,44,0,0,49,44,0,0,44,0,49
2024-10-08,28éûîº,93,49,44,0,0,49,44,0,0,44,0,49,49,44,0,0,49,44,0,0,44,0,49
2024-10-09,5éû,44,0,44,0,0,0,44,0,0,44,0,0,0,44,0,0,0,44,0,0,44,0,0
2024-10-09,5éûîº,44,0,44,0,0,0,44,0,0,44,0,0,0,44,0,0,0,44,0,0,44,0,0
2024-10-09,6éû,44,0,44,0,0,0,44,0,0,44,0,0,0,44,0,0,0,44,0,0,44,0,0
2024-10-09,6éûîº,105,61,44,0,0,61,44,0,0,44,0,61,61,44,0,0,61,44,0,0,44,0,61
2024-10-09,7éû,109,65,44,0,0,65,44,0,0,44,0,65,65,44,0,0,65,44,0,0,44,0,65
2024-10-09,7éûîº,65,21,44,0,0,0,44,21,0,44,0,21,21,44,0,0,0,44,21,0,44,0,21
2024-10-09,8éû,169,24,145,0,101,0,68,0,0,44,101,24,24,145,0,101,0,68,0,0,44,101,24
2024-10-09,8éûîº,176,31,145,0,101,0,75,0,0,44,101,31,31,145,0,101,0,75,0,0,44,101,31
2024-10-09,9éû,234,51,183,0,101,51,82,0,0,44,190,0,51,183,0,101,51,82,0,0,44,190,0
2024-10-09,9éûîº,372,102,270,0,151,138,82,0,0,44,277,50,102,270,0,151,138,82,0,0,44,277,50
2024-10-09,10éû,389,119,270,0,101,138,82,0,67,78,277,33,119,270,0,101,138,82,0,67,78,277,33
2024-10-09,10éûîº,399,129,270,0,101,148,82,0,67,78,225,95,129,270,0,101,148,82,0,67,78,225,95
2024-10-09,11éû,613,343,270,0,101,308,108,26,67,78,277,257,343,270,0,101,308,108,26,67,78,277,257
2024-10-09,11éûîº,980,247,733,256,244,310,108,26,33,78,420,481,247,733,256,244,310,108,26,33,78,420,481
2024-10-09,12éû,874,206,668,256,101,371,82,30,33,78,307,488,206,668,256,101,371,82,30,33,78,307,488
2024-10-09,12éûîº,1001,298,703,256,244,433,37,30,0,205,307,488,298,703,256,244,433,37,30,0,205,307,488
2024-10-09,13éû,1208,336,872,362,306,434,81,0,24,143,341,723,336,872,362,306,434,81,0,24,143,341,723
2024-10-09,13éûîº,903,195,708,362,61,361,81,36,0,0,240,663,195,708,362,61,361,81,36,0,0,240,663
2024-10-09,14éû,1231,223,1008,362,321,361,109,36,39,0,431,799,223,1008,362,321,361,109,36,39,0,431,799
2024-10-09,14éûîº,916,242,674,106,321,283,99,66,39,74,393,448,242,674,106,321,283,99,66,39,74,393,448
2024-10-09,15éû,1178,325,853,106,501,283,157,91,39,74,393,711,325,853,106,501,283,157,91,39,74,393,711
2024-10-09,15éûîº,1594,402,1192,368,622,328,145,91,39,0,393,1201,402,1192,368,622,328,145,91,39,0,393,1201
2024-10-09,16éû,1723,455,1268,368,766,283,145,120,39,0,393,1330,455,1268,368,766,283,145,120,39,0,393,1330
2024-10-09,16éûîº,1755,659,1096,232,755,338,339,90,0,0,393,1362,659,1096,232,755,338,339,90,0,0,393,1362
2024-10-09,17éû,2856,887,1969,680,1175,338,429,232,0,0,393,2462,887,1969,680,1175,338,429,232,0,0,393,2462
2024-10-09,17éûîº,3985,1564,2421,939,1391,588,770,295,0,143,342,3500,1564,2421,939,1391,588,770,295,0,143,342,3500
2024-10-09,18éû,4322,1792,2530,1221,1438,387,833,394,46,143,262,3916,1792,2530,1221,1438,387,833,394,46,143,262,3916
2024-10-09,18éûîº,3864,1733,2131,1075,1476,357,562,309,82,143,262,3459,1733,2131,1075,1476,357,562,309,82,143,262,3459
2024-10-09,19éû,3627,1571,2056,955,1389,465,495,276,46,205,262,3159,1571,2056,955,1389,465,495,276,46,205,262,3159
2024-10-09,19éûîº,3682,1562,2120,955,1325,616,499,239,46,205,198,3278,1562,2120,955,1325,616,499,239,46,205,198,3278
2024-10-09,20éû,3446,1371,2075,955,1325,371,529,217,46,143,176,3126,1371,2075,955,1325,371,529,217,46,143,176,3126
2024-10-09,20éûîº,3044,1454,1590,955,1174,120,529,217,46,82,90,2871,1454,1590,955,1174,120,529,217,46,82,90,2871
2024-10-09,21éû,2989,1366,1623,955,1037,174,524,251,46,0,90,2899,1366,1623,955,1037,174,524,251,46,0,90,2899
2024-10-09,21éûîº,1592,585,1007,409,641,74,387,33,46,0,0,1593,585,1007,409,641,74,387,33,46,0,0,1593
2024-10-09,22éû,862,228,634,303,183,37,257,33,46,0,0,862,228,634,303,183,37,257,33,46,0,0,862
2024-10-09,22éûîº,741,105,636,559,68,37,44,33,0,0,0,742,105,636,559,68,37,44,33,0,0,0,742
2024-10-09,23éû,664,105,559,559,68,37,0,0,0,0,0,664,105,559,559,68,37,0,0,0,0,0,664
2024-10-09,23éûîº,105,105,0,0,68,37,0,0,0,0,0,105,105,0,0,68,37,0,0,0,0,0,105
2024-10-09,24éû,0,0,0,0,0,0,0,0,0,0,0,0,0,0,0,0,0,0,0,0,0,0,0
2024-10-09,24éûîº,0,0,0,0,0,0,0,0,0,0,0,0,0,0,0,0,0,0,0,0,0,0,0
2024-10-09,25éû,0,0,0,0,0,0,0,0,0,0,0,0,0,0,0,0,0,0,0,0,0,0,0
2024-10-09,25éûîº,0,0,0,0,0,0,0,0,0,0,0,0,0,0,0,0,0,0,0,0,0,0,0
2024-10-09,26éû,0,0,0,0,0,0,0,0,0,0,0,0,0,0,0,0,0,0,0,0,0,0,0
2024-10-09,26éûîº,0,0,0,0,0,0,0,0,0,0,0,0,0,0,0,0,0,0,0,0,0,0,0
2024-10-09,27éû,0,0,0,0,0,0,0,0,0,0,0,0,0,0,0,0,0,0,0,0,0,0,0
2024-10-09,27éûîº,0,0,0,0,0,0,0,0,0,0,0,0,0,0,0,0,0,0,0,0,0,0,0
2024-10-09,28éû,0,0,0,0,0,0,0,0,0,0,0,0,0,0,0,0,0,0,0,0,0,0,0
2024-10-09,28éûîº,0,0,0,0,0,0,0,0,0,0,0,0,0,0,0,0,0,0,0,0,0,0,0
2024-10-10,5éû,0,0,0,0,0,0,0,0,0,0,0,0,0,0,0,0,0,0,0,0,0,0,0
2024-10-10,5éûîº,0,0,0,0,0,0,0,0,0,0,0,0,0,0,0,0,0,0,0,0,0,0,0
2024-10-10,6éû,0,0,0,0,0,0,0,0,0,0,0,0,0,0,0,0,0,0,0,0,0,0,0
2024-10-10,6éûîº,46,46,0,0,0,0,0,0,46,0,46,0,46,0,0,0,0,0,0,46,0,46,0
2024-10-10,7éû,100,100,0,0,0,53,0,0,46,0,46,53,100,0,0,0,53,0,0,46,0,46,53
2024-10-10,7éûîº,0,0,0,0,0,0,0,0,0,0,0,0,0,0,0,0,0,0,0,0,0,0,0
2024-10-10,8éû,0,0,0,0,0,0,0,0,0,0,0,0,0,0,0,0,0,0,0,0,0,0,0
2024-10-10,8éûîº,89,89,0,0,0,89,0,0,0,0,0,89,89,0,0,0,89,0,0,0,0,0,89
2024-10-10,9éû,42,42,0,0,0,42,0,0,0,0,0,42,42,0,0,0,42,0,0,0,0,0,42
2024-10-10,9éûîº,139,97,42,0,0,97,42,0,0,0,0,139,97,42,0,0,97,42,0,0,0,0,139
2024-10-10,10éû,447,274,173,0,151,184,86,25,0,0,155,292,274,173,0,151,184,86,25,0,0,155,292
2024-10-10,10éûîº,902,388,514,222,151,394,86,48,0,61,155,685,388,514,222,151,394,86,48,0,61,155,685
2024-10-10,11éû,976,380,596,392,154,339,42,48,0,61,155,759,380,596,392,154,339,42,48,0,61,155,759
2024-10-10,11éûîº,1079,284,795,262,209,370,82,154,0,92,155,831,284,795,262,209,370,82,154,0,92,155,831
2024-10-10,12éû,1239,324,915,262,477,277,33,188,0,0,185,1054,324,915,262,477,277,33,188,0,0,185,1054
2024-10-10,12éûîº,1376,307,1069,262,538,275,117,133,49,0,155,1221,307,1069,262,538,275,117,133,49,0,155,1221
2024-10-10,13éû,1386,290,1096,262,653,332,69,69,0,0,155,1231,290,1096,262,653,332,69,69,0,0,155,1231
2024-10-10,13éûîº,1356,302,1054,262,638,199,82,138,33,33,208,1114,302,1054,262,638,199,82,138,33,33,208,1114
2024-10-10,14éû,1265,277,988,262,577,197,29,164,33,33,155,1076,277,988,262,577,197,29,164,33,33,155,1076
2024-10-10,14éûîº,1323,352,971,262,434,330,165,131,0,0,155,1169,352,971,262,434,330,165,131,0,0,155,1169
2024-10-10,15éû,1174,313,861,262,292,306,153,161,0,29,155,990,313,861,262,292,306,153,161,0,29,155,990
2024-10-10,15éûîº,1821,515,1306,777,377,254,289,123,0,0,155,1667,515,1306,777,377,254,289,123,0,0,155,1667
2024-10-10,16éû,1986,645,1341,777,334,254,426,155,39,39,155,1792,645,1341,777,334,254,426,155,39,39,155,1792
2024-10-10,16éûîº,2811,1237,1574,1045,496,509,527,192,39,101,155,2554,1237,1574,1045,496,509,527,192,39,101,155,2554
2024-10-10,17éû,3443,1541,1902,1158,334,623,682,453,190,79,155,3209,1541,1902,1158,334,623,682,453,190,79,155,3209
2024-10-10,17éûîº,3737,1806,1931,896,512,894,712,530,190,204,155,3377,1806,1931,896,512,894,712,530,190,204,155,3377
2024-10-10,18éû,3190,1557,1633,1018,157,908,647,380,79,165,155,2869,1557,1633,1018,157,908,647,380,79,165,155,2869
2024-10-10,18éûîº,2806,1377,1429,905,157,808,612,284,39,132,155,2520,1377,1429,905,157,808,612,284,39,132,155,2520
2024-10-10,19éû,2412,1253,1159,905,157,481,554,274,39,161,155,2095,1253,1159,905,157,481,554,274,39,161,155,2095
2024-10-10,19éûîº,2380,1221,1159,905,157,480,554,244,39,193,155,2031,1221,1159,905,157,480,554,244,39,193,155,2031
2024-10-10,20éû,2367,1185,1182,905,157,558,435,271,39,132,155,2080,1185,1182,905,157,558,435,271,39,132,155,2080
2024-10-10,20éûîº,2637,1250,1387,792,379,600,498,271,96,193,155,2288,1250,1387,792,379,600,498,271,96,193,155,2288
2024-10-10,21éû,1398,687,711,268,176,535,186,135,96,193,68,1136,687,711,268,176,535,186,135,96,193,68,1136
2024-10-10,21éûîº,1005,411,594,268,68,413,58,100,96,193,68,743,411,594,268,68,413,58,100,96,193,68,743
2024-10-10,22éû,853,336,517,268,68,363,58,55,39,193,68,591,336,517,268,68,363,58,55,39,193,68,591
2024-10-10,22éûîº,805,371,434,331,68,319,31,55,0,154,68,582,371,434,331,68,319,31,55,0,154,68,582
2024-10-10,23éû,232,113,119,0,0,177,0,55,0,154,0,77,113,119,0,0,177,0,55,0,154,0,77
2024-10-10,23éûîº,203,84,119,0,0,177,0,26,0,154,0,49,84,119,0,0,177,0,26,0,154,0,49
2024-10-10,24éû,26,0,26,0,0,0,0,26,0,0,0,26,0,26,0,0,0,0,26,0,0,0,26
2024-10-10,24éûîº,26,0,26,0,0,0,0,26,0,0,0,26,0,26,0,0,0,0,26,0,0,0,26
2024-10-10,25éû,82,56,26,0,56,0,0,26,0,0,0,83,56,26,0,56,0,0,26,0,0,0,83
2024-10-10,25éûîº,26,0,26,0,0,0,0,26,0,0,0,26,0,26,0,0,0,0,26,0,0,0,26
2024-10-10,26éû,26,0,26,0,0,0,0,26,0,0,0,26,0,26,0,0,0,0,26,0,0,0,26
2024-10-10,26éûîº,26,0,26,0,0,0,0,26,0,0,0,26,0,26,0,0,0,0,26,0,0,0,26
2024-10-10,27éû,26,0,26,0,0,0,0,26,0,0,0,26,0,26,0,0,0,0,26,0,0,0,26
2024-10-10,27éûîº,26,0,26,0,0,0,0,26,0,0,0,26,0,26,0,0,0,0,26,0,0,0,26
2024-10-10,28éû,26,0,26,0,0,0,0,26,0,0,0,26,0,26,0,0,0,0,26,0,0,0,26
2024-10-10,28éûîº,26,0,26,0,0,0,0,26,0,0,0,26,0,26,0,0,0,0,26,0,0,0,26
2024-10-11,5éû,378,113,265,265,82,0,31,0,0,82,0,296,113,265,265,82,0,31,0,0,82,0,296
2024-10-11,5éûîº,378,113,265,265,82,0,31,0,0,82,0,296,113,265,265,82,0,31,0,0,82,0,296
2024-10-11,6éû,442,113,329,265,82,64,31,0,0,82,0,360,113,329,265,82,64,31,0,0,82,0,360
2024-10-11,6éûîº,494,165,329,265,82,116,31,0,0,82,51,360,165,329,265,82,116,31,0,0,82,51,360
2024-10-11,7éû,411,82,329,265,0,116,31,0,0,0,51,360,82,329,265,0,116,31,0,0,0,51,360
2024-10-11,7éûîº,530,201,329,265,56,178,31,0,0,61,51,417,201,329,265,56,178,31,0,0,61,51,417
2024-10-11,8éû,737,217,520,265,191,220,31,29,0,91,243,403,217,520,265,191,220,31,29,0,91,243,403
2024-10-11,8éûîº,673,217,456,265,191,156,31,29,0,91,243,338,217,456,265,191,156,31,29,0,91,243,338
2024-10-11,9éû,650,156,494,265,191,156,37,0,0,61,280,307,156,494,265,191,156,37,0,0,61,280,307
2024-10-11,9éûîº,801,182,619,265,259,200,75,0,0,61,436,303,182,619,265,259,200,75,0,0,61,436,303
2024-10-11,10éû,1010,286,724,265,403,305,37,0,0,123,436,451,286,724,265,403,305,37,0,0,123,436,451
2024-10-11,10éûîº,1383,403,980,521,456,308,98,0,0,123,384,876,403,980,521,456,308,98,0,0,123,384,876
2024-10-11,11éû,1758,590,1168,521,541,597,98,0,0,123,521,1113,590,1168,521,541,597,98,0,0,123,521,1113
2024-10-11,11éûîº,2004,444,1560,521,867,547,68,0,0,61,587,1355,444,1560,521,867,547,68,0,0,61,587,1355
2024-10-11,12éû,2489,515,1974,521,1052,773,82,60,0,61,761,1666,515,1974,521,1052,773,82,60,0,61,761,1666
2024-10-11,12éûîº,2899,693,2206,521,1151,920,106,89,109,154,761,1983,693,2206,521,1151,920,106,89,109,154,761,1983
2024-10-11,13éû,2962,689,2273,776,1216,726,82,89,72,61,706,2194,689,2273,776,1216,726,82,89,72,61,706,2194
2024-10-11,13éûîº,3172,742,2430,935,1024,869,224,30,88,61,643,2468,742,2430,935,1024,869,224,30,88,61,643,2468
2024-10-11,14éû,2703,553,2150,935,782,628,188,0,169,61,698,1944,553,2150,935,782,628,188,0,169,61,698,1944
2024-10-11,14éûîº,2383,610,1773,935,782,469,80,56,59,61,541,1779,610,1773,935,782,469,80,56,59,61,541,1779
2024-10-11,15éû,2004,575,1429,679,638,462,80,56,86,61,541,1400,575,1429,679,638,462,80,56,86,61,541,1400
2024-10-11,15éûîº,2026,713,1313,679,638,532,31,59,86,61,541,1423,713,1313,679,638,532,31,59,86,61,541,1423
2024-10-11,16éû,1996,751,1245,674,638,596,0,59,28,61,605,1329,751,1245,674,638,596,0,59,28,61,605,1329
2024-10-11,16éûîº,2203,816,1387,797,867,409,0,129,0,91,519,1592,816,1387,797,867,409,0,129,0,91,519,1592
2024-10-11,17éû,1733,591,1142,496,814,294,0,127,0,61,519,1152,591,1142,496,814,294,0,127,0,61,519,1152
2024-10-11,17éûîº,1550,578,972,159,913,283,102,58,33,61,467,1021,578,972,159,913,283,102,58,33,61,467,1021
2024-10-11,18éû,1526,520,1006,159,1098,107,69,58,33,0,403,1123,520,1006,159,1098,107,69,58,33,0,403,1123
2024-10-11,18éûîº,1165,512,653,159,764,94,113,0,33,44,211,908,512,653,159,764,94,113,0,33,44,211,908
2024-10-11,19éû,1432,525,907,159,907,205,160,0,0,235,211,984,525,907,159,907,205,160,0,0,235,211,984
2024-10-11,19éûîº,1363,603,760,159,891,175,138,0,0,249,211,901,603,760,159,891,175,138,0,0,249,211,901
2024-10-11,20éû,1766,620,1146,424,861,275,171,33,0,282,298,1184,620,1146,424,861,275,171,33,0,282,298,1184
2024-10-11,20éûîº,1298,289,1009,265,710,188,100,33,0,238,298,761,289,1009,265,710,188,100,33,0,238,298,761
2024-10-11,21éû,1330,378,952,265,797,203,31,33,0,205,211,913,378,952,265,797,203,31,33,0,205,211,913
2024-10-11,21éûîº,1654,456,1198,265,1073,250,31,33,0,288,211,1154,456,1198,265,1073,250,31,33,0,288,211,1154
2024-10-11,22éû,1022,321,701,265,604,51,67,33,0,82,68,871,321,701,265,604,51,67,33,0,82,68,871
2024-10-11,22éûîº,739,321,418,265,358,51,31,33,0,82,68,588,321,418,265,358,51,31,33,0,82,68,588
2024-10-11,23éû,768,350,418,265,358,51,93,0,0,82,68,617,350,418,265,358,51,93,0,0,82,68,617
2024-10-11,23éûîº,670,252,418,265,289,51,64,0,0,82,0,588,252,418,265,289,51,64,0,0,82,0,588
2024-10-11,24éû,618,200,418,265,289,0,64,0,0,82,0,536,200,418,265,289,0,64,0,0,82,0,536
2024-10-11,24éûîº,499,200,299,265,169,0,64,0,0,82,0,417,200,299,265,169,0,64,0,0,82,0,417
2024-10-11,25éû,465,200,265,265,169,0,31,0,0,82,0,383,200,265,265,169,0,31,0,0,82,0,383
2024-10-11,25éûîº,492,227,265,265,169,0,58,0,0,82,0,410,227,265,265,169,0,58,0,0,82,0,410
2024-10-11,26éû,465,200,265,265,169,0,31,0,0,82,0,383,200,265,265,169,0,31,0,0,82,0,383
2024-10-11,26éûîº,465,200,265,265,169,0,31,0,0,82,0,383,200,265,265,169,0,31,0,0,82,0,383
2024-10-11,27éû,465,200,265,265,169,0,31,0,0,82,0,383,200,265,265,169,0,31,0,0,82,0,383
2024-10-11,27éûîº,465,200,265,265,169,0,31,0,0,82,0,383,200,265,265,169,0,31,0,0,82,0,383
2024-10-11,28éû,465,200,265,265,169,0,31,0,0,82,0,383,200,265,265,169,0,31,0,0,82,0,383
2024-10-11,28éûîº,465,200,265,265,169,0,31,0,0,82,0,383,200,265,265,169,0,31,0,0,82,0,383
2024-10-12,5éû,0,0,0,0,0,0,0,0,0,0,0,0,0,0,0,0,0,0,0,0,0,0,0
2024-10-12,5éûîº,0,0,0,0,0,0,0,0,0,0,0,0,0,0,0,0,0,0,0,0,0,0,0
2024-10-12,6éû,74,74,0,0,0,44,0,29,0,0,29,44,74,0,0,0,44,0,29,0,0,29,44
2024-10-12,6éûîº,44,44,0,0,0,44,0,0,0,0,0,44,44,0,0,0,44,0,0,0,0,0,44
2024-10-12,7éû,0,0,0,0,0,0,0,0,0,0,0,0,0,0,0,0,0,0,0,0,0,0,0
2024-10-12,7éûîº,0,0,0,0,0,0,0,0,0,0,0,0,0,0,0,0,0,0,0,0,0,0,0
2024-10-12,8éû,142,50,92,0,0,92,50,0,0,92,0,50,50,92,0,0,92,50,0,0,92,0,50
2024-10-12,8éûîº,231,139,92,0,0,144,50,37,0,92,51,87,139,92,0,0,144,50,37,0,92,51,87
2024-10-12,9éû,300,263,37,0,0,97,140,63,0,0,89,211,263,37,0,0,97,140,63,0,0,89,211
2024-10-12,9éûîº,424,348,76,0,0,182,178,63,0,0,89,335,348,76,0,0,182,178,63,0,0,89,335
2024-10-12,10éû,1015,821,194,247,36,431,210,90,0,0,176,839,821,194,247,36,431,210,90,0,0,176,839
2024-10-12,10éûîº,1023,642,381,112,36,502,240,92,39,39,176,807,642,381,112,36,502,240,92,39,39,176,807
2024-10-12,11éû,1908,1013,895,628,195,530,391,123,39,39,266,1603,1013,895,628,195,530,391,123,39,39,266,1603
2024-10-12,11éûîº,2932,1470,1462,1137,213,790,479,129,182,0,266,2666,1470,1462,1137,213,790,479,129,182,0,266,2666
2024-10-12,12éû,3399,1770,1629,1090,261,1151,609,104,182,0,266,3134,1770,1629,1090,261,1151,609,104,182,0,266,3134
2024-10-12,12éûîº,2681,1456,1225,529,321,1065,621,98,46,61,266,2353,1456,1225,529,321,1065,621,98,46,61,266,2353
2024-10-12,13éû,2935,1579,1356,377,449,1204,694,165,46,61,266,2608,1579,1356,377,449,1204,694,165,46,61,266,2608
2024-10-12,13éûîº,3132,1247,1885,256,766,1147,717,246,0,61,266,2805,1247,1885,256,766,1147,717,246,0,61,266,2805
2024-10-12,14éû,3606,1307,2299,378,655,1463,848,216,43,61,330,3214,1307,2299,378,655,1463,848,216,43,61,330,3214
2024-10-12,14éûîº,3747,1424,2323,664,517,1558,685,278,43,61,292,3393,1424,2323,664,517,1558,685,278,43,61,292,3393
2024-10-12,15éû,3815,1384,2431,524,615,1572,769,332,0,29,292,3492,1384,2431,524,615,1572,769,332,0,29,292,3492
2024-10-12,15éûîº,4331,1555,2776,412,715,1928,859,362,52,92,292,3946,1555,2776,412,715,1928,859,362,52,92,292,3946
2024-10-12,16éû,5887,2688,3199,1210,912,2323,982,407,52,208,292,5387,2688,3199,1210,912,2323,982,407,52,208,292,5387
2024-10-12,16éûîº,5554,2687,2867,1508,779,2041,847,274,103,208,240,5106,2687,2867,1508,779,2041,847,274,103,208,240,5106
2024-10-12,17éû,4473,2006,2467,875,880,1689,769,154,103,61,292,4118,2006,2467,875,880,1689,769,154,103,61,292,4118
2024-10-12,17éûîº,4853,2180,2673,1382,699,1576,920,154,120,95,240,4517,2180,2673,1382,699,1576,920,154,120,95,240,4517
2024-10-12,18éû,4837,2121,2716,1227,701,1659,980,148,120,95,240,4500,2121,2716,1227,701,1659,980,148,120,95,240,4500
2024-10-12,18éûîº,4632,2235,2397,962,709,1721,1024,148,67,95,240,4296,2235,2397,962,709,1721,1024,148,67,95,240,4296
2024-10-12,19éû,5156,2125,3031,1168,706,1740,1267,175,99,92,240,4823,2125,3031,1168,706,1740,1267,175,99,92,240,4823
2024-10-12,19éûîº,3386,1291,2095,637,744,890,927,122,65,0,240,3146,1291,2095,637,744,890,927,122,65,0,240,3146
2024-10-12,20éû,2801,912,1889,431,662,726,818,97,65,0,240,2561,912,1889,431,662,726,818,97,65,0,240,2561
2024-10-12,20éûîº,2125,740,1385,431,261,618,679,70,65,0,150,1975,740,1385,431,261,618,679,70,65,0,150,1975
2024-10-12,21éû,1671,604,1067,561,184,276,547,36,65,0,63,1607,604,1067,561,184,276,547,36,65,0,63,1607
2024-10-12,21éûîº,1427,456,971,473,184,328,375,0,65,0,63,1364,456,971,473,184,328,375,0,65,0,63,1364
2024-10-12,22éû,1343,427,916,473,184,283,337,0,65,0,63,1280,427,916,473,184,283,337,0,65,0,63,1280
2024-10-12,22éûîº,1050,235,815,339,184,283,242,0,0,0,63,986,235,815,339,184,283,242,0,0,0,63,986
2024-10-12,23éû,715,48,667,256,111,166,180,0,0,0,0,715,48,667,256,111,166,180,0,0,0,0,715
2024-10-12,23éûîº,567,48,519,256,0,166,145,0,0,0,0,568,48,519,256,0,166,145,0,0,0,0,568
2024-10-12,24éû,159,27,132,0,0,66,66,27,0,0,0,159,27,132,0,0,66,66,27,0,0,0,159
2024-10-12,24éûîº,159,27,132,0,0,66,66,27,0,0,0,159,27,132,0,0,66,66,27,0,0,0,159
2024-10-12,25éû,159,27,132,0,0,66,66,27,0,0,0,159,27,132,0,0,66,66,27,0,0,0,159
2024-10-12,25éûîº,159,27,132,0,0,66,66,27,0,0,0,159,27,132,0,0,66,66,27,0,0,0,159
2024-10-12,26éû,197,27,170,0,0,66,104,27,0,0,0,198,27,170,0,0,66,104,27,0,0,0,198
2024-10-12,26éûîº,170,0,170,0,0,66,104,0,0,0,0,170,0,170,0,0,66,104,0,0,0,0,170
2024-10-12,27éû,170,0,170,0,0,66,104,0,0,0,0,170,0,170,0,0,66,104,0,0,0,0,170
2024-10-12,27éûîº,132,0,132,0,0,66,66,0,0,0,0,132,0,132,0,0,66,66,0,0,0,0,132
2024-10-12,28éû,185,53,132,0,0,119,66,0,0,0,0,185,53,132,0,0,119,66,0,0,0,0,185
2024-10-12,28éûîº,185,53,132,0,0,119,66,0,0,0,0,185,53,132,0,0,119,66,0,0,0,0,185
2024-10-13,5éû,135,0,135,0,0,66,69,0,0,0,0,135,0,135,0,0,66,69,0,0,0,0,135
2024-10-13,5éûîº,96,0,96,0,0,66,30,0,0,0,0,96,0,96,0,0,66,30,0,0,0,0,96
2024-10-13,6éû,66,0,66,0,0,66,0,0,0,0,0,66,0,66,0,0,66,0,0,0,0,0,66
2024-10-13,6éûîº,66,0,66,0,0,66,0,0,0,0,0,66,0,66,0,0,66,0,0,0,0,0,66
2024-10-13,7éû,173,107,66,107,0,66,0,0,0,0,0,173,107,66,107,0,66,0,0,0,0,0,173
2024-10-13,7éûîº,173,107,66,107,0,66,0,0,0,0,0,173,107,66,107,0,66,0,0,0,0,0,173
2024-10-13,8éû,395,138,257,107,191,97,0,0,0,0,191,205,138,257,107,191,97,0,0,0,0,191,205
2024-10-13,8éûîº,409,152,257,0,259,149,0,0,0,0,311,97,152,257,0,259,149,0,0,0,0,311,97
2024-10-13,9éû,599,342,257,159,259,180,0,0,0,0,311,288,342,257,159,259,180,0,0,0,0,311,288
2024-10-13,9éûîº,754,318,436,159,298,297,0,0,0,92,398,264,318,436,159,298,297,0,0,0,92,398,264
2024-10-13,10éû,1621,907,714,476,458,404,131,24,127,132,398,1091,907,714,476,458,404,131,24,127,132,398,1091
2024-10-13,10éûîº,1527,710,817,239,674,311,98,24,179,39,398,1089,710,817,239,674,311,98,24,179,39,398,1089
2024-10-13,11éû,2033,942,1091,380,948,310,139,110,144,29,346,1656,942,1091,380,948,310,139,110,144,29,346,1656
2024-10-13,11éûîº,2694,1094,1600,713,959,516,294,109,101,29,541,2123,1094,1600,713,959,516,294,109,101,29,541,2123
2024-10-13,12éû,3153,1276,1877,1028,905,674,234,138,172,29,541,2582,1276,1877,1028,905,674,234,138,172,29,541,2582
2024-10-13,12éûîº,3018,1091,1927,673,895,816,326,134,172,29,541,2447,1091,1927,673,895,816,326,134,172,29,541,2447
2024-10-13,13éû,2469,1119,1350,451,736,673,264,195,147,29,541,1898,1119,1350,451,736,673,264,195,147,29,541,1898
2024-10-13,13éûîº,2984,1293,1691,451,955,970,257,201,147,214,541,2227,1293,1691,451,955,970,257,201,147,214,541,2227
2024-10-13,14éû,2838,1330,1508,487,1026,883,147,202,91,29,541,2267,1330,1508,487,1026,883,147,202,91,29,541,2267
2024-10-13,14éûîº,3337,1472,1865,405,1403,1108,153,199,67,29,541,2766,1472,1865,405,1403,1108,153,199,67,29,541,2766
2024-10-13,15éû,2907,1078,1829,159,1112,1127,166,295,46,74,541,2291,1078,1829,159,1112,1127,166,295,46,74,541,2291
2024-10-13,15éûîº,2958,1354,1604,482,665,1229,230,350,0,74,398,2486,1354,1604,482,665,1229,230,350,0,74,398,2486
2024-10-13,16éû,2449,1236,1213,292,592,1122,198,243,0,29,398,2021,1236,1213,292,592,1122,198,243,0,29,398,2021
2024-10-13,16éûîº,2637,1323,1314,675,509,1013,189,223,27,63,398,2176,1323,1314,675,509,1013,189,223,27,63,398,2176
2024-10-13,17éû,2462,1244,1218,502,442,1086,226,177,27,91,398,1973,1244,1218,502,442,1086,226,177,27,91,398,1973
2024-10-13,17éûîº,2060,884,1176,292,546,756,164,233,66,59,398,1602,884,1176,292,546,756,164,233,66,59,398,1602
2024-10-13,18éû,2048,943,1105,292,623,614,205,246,66,59,297,1692,943,1105,292,623,614,205,246,66,59,297,1692
2024-10-13,18éûîº,1687,935,752,403,378,414,302,162,27,29,207,1451,935,752,403,378,414,302,162,27,29,207,1451
2024-10-13,19éû,1332,727,605,292,309,357,161,184,27,29,207,1096,727,605,292,309,357,161,184,27,29,207,1096
2024-10-13,19éûîº,1300,766,534,415,213,316,192,135,27,29,155,1115,766,534,415,213,316,192,135,27,29,155,1115
2024-10-13,20éû,1471,794,677,415,356,429,162,108,0,235,155,1081,794,677,415,356,429,162,108,0,235,155,1081
2024-10-13,20éûîº,1528,817,711,415,356,429,218,108,0,235,155,1138,817,711,415,356,429,218,108,0,235,155,1138
2024-10-13,21éû,1231,607,624,292,424,280,155,78,0,143,68,1019,607,624,292,424,280,155,78,0,143,68,1019
2024-10-13,21éûîº,1207,653,554,422,383,151,142,108,0,173,68,966,653,554,422,383,151,142,108,0,173,68,966
2024-10-13,22éû,1109,639,470,422,315,151,152,68,0,173,68,867,639,470,422,315,151,152,68,0,173,68,867
2024-10-13,22éûîº,705,482,223,292,68,213,33,97,0,59,68,577,482,223,292,68,213,33,97,0,59,68,577
2024-10-13,23éû,678,489,189,292,137,151,0,97,0,59,68,550,489,189,292,137,151,0,97,0,59,68,550
2024-10-13,23éûîº,293,255,38,133,0,61,0,97,0,59,0,234,255,38,133,0,61,0,97,0,59,0,234
2024-10-13,24éû,322,284,38,133,0,61,0,127,0,89,0,234,284,38,133,0,61,0,127,0,89,0,234
2024-10-13,24éûîº,260,222,38,133,0,0,0,127,0,89,0,172,222,38,133,0,0,0,127,0,89,0,172
2024-10-13,25éû,185,89,96,0,0,0,58,127,0,89,0,96,89,96,0,0,0,58,127,0,89,0,96
2024-10-13,25éûîº,147,89,58,0,0,0,58,89,0,89,0,58,89,58,0,0,0,58,89,0,89,0,58
2024-10-13,26éû,147,89,58,0,0,0,58,89,0,89,0,58,89,58,0,0,0,58,89,0,89,0,58
2024-10-13,26éûîº,147,89,58,0,0,0,58,89,0,89,0,58,89,58,0,0,0,58,89,0,89,0,58
2024-10-13,27éû,147,89,58,0,0,0,58,89,0,89,0,58,89,58,0,0,0,58,89,0,89,0,58
2024-10-13,27éûîº,147,89,58,0,0,0,58,89,0,89,0,58,89,58,0,0,0,58,89,0,89,0,58
2024-10-13,28éû,147,89,58,0,0,0,58,89,0,89,0,58,89,58,0,0,0,58,89,0,89,0,58
2024-10-13,28éûîº,147,89,58,0,0,0,58,89,0,89,0,58,89,58,0,0,0,58,89,0,89,0,58
2024-10-14,5éû,163,89,74,0,0,0,74,89,0,89,0,74,89,74,0,0,0,74,89,0,89,0,74
2024-10-14,5éûîº,130,89,41,0,0,0,41,89,0,89,0,41,89,41,0,0,0,41,89,0,89,0,41
2024-10-14,6éû,157,116,41,0,0,0,69,89,0,89,0,69,116,41,0,0,0,69,89,0,89,0,69
2024-10-14,6éûîº,154,113,41,0,0,0,66,89,0,89,0,66,113,41,0,0,0,66,89,0,89,0,66
2024-10-14,7éû,154,113,41,0,0,0,66,89,0,89,0,66,113,41,0,0,0,66,89,0,89,0,66
2024-10-14,7éûîº,157,89,68,0,0,0,68,89,0,89,0,68,89,68,0,0,0,68,89,0,89,0,68
2024-10-14,8éû,217,89,128,0,101,0,27,89,0,89,101,27,89,128,0,101,0,27,89,0,89,101,27
2024-10-14,8éûîº,409,190,219,0,169,61,118,59,0,59,169,180,190,219,0,169,61,118,59,0,59,169,180
2024-10-14,9éû,576,293,283,103,169,61,149,91,0,59,169,347,293,283,103,169,61,149,91,0,59,169,347
2024-10-14,9éûîº,748,250,498,122,248,0,253,124,0,59,207,482,250,498,122,248,0,253,124,0,59,207,482
2024-10-14,10éû,800,215,585,0,248,148,253,124,25,59,294,447,215,585,0,248,148,253,124,25,59,294,447
2024-10-14,10éûîº,1215,490,725,104,352,347,289,95,25,29,294,891,490,725,104,352,347,289,95,25,29,294,891
2024-10-14,11éû,1470,683,787,0,476,341,430,222,0,91,294,1084,683,787,0,476,341,430,222,0,91,294,1084
2024-10-14,11éûîº,1856,665,1191,0,619,545,446,245,0,29,504,1323,665,1191,0,619,545,446,245,0,29,504,1323
2024-10-14,12éû,2172,942,1230,0,800,677,421,271,0,29,504,1638,942,1230,0,800,677,421,271,0,29,504,1638
2024-10-14,12éûîº,2430,817,1613,0,899,613,568,349,0,29,504,1896,817,1613,0,899,613,568,349,0,29,504,1896
2024-10-14,13éû,2618,841,1777,0,785,785,641,364,42,29,501,2088,841,1777,0,785,785,641,364,42,29,501,2088
2024-10-14,13éûîº,2915,868,2047,0,706,1074,726,366,42,59,501,2354,868,2047,0,706,1074,726,366,42,59,501,2354
2024-10-14,14éû,3879,1135,2744,376,673,1222,1094,471,42,59,362,3457,1135,2744,376,673,1222,1094,471,42,59,362,3457
2024-10-14,14éûîº,4234,1384,2850,402,649,1212,1423,417,129,74,362,3798,1384,2850,402,649,1212,1423,417,129,74,362,3798
2024-10-14,15éû,4279,1397,2882,297,550,1130,1602,450,247,0,298,3980,1397,2882,297,550,1130,1602,450,247,0,298,3980
2024-10-14,15éûîº,5116,1293,3823,175,736,1534,1846,508,314,0,298,4817,1293,3823,175,736,1534,1846,508,314,0,298,4817
2024-10-14,16éû,6463,1547,4916,491,885,1442,2521,842,280,29,298,6134,1547,4916,491,885,1442,2521,842,280,29,298,6134
2024-10-14,16éûîº,7197,1764,5433,612,743,1806,2865,914,256,29,294,6874,1764,5433,612,743,1806,2865,914,256,29,294,6874
2024-10-14,17éû,6497,1389,5108,322,652,1799,2647,820,256,74,294,6129,1389,5108,322,652,1799,2647,820,256,74,294,6129
2024-10-14,17éûîº,6032,1441,4591,498,1221,1206,2356,595,155,74,395,5563,1441,4591,498,1221,1206,2356,595,155,74,395,5563
2024-10-14,18éû,5007,1328,3679,498,937,852,2023,595,101,91,294,4622,1328,3679,498,937,852,2023,595,101,91,294,4622
2024-10-14,18éûîº,5094,1295,3799,498,1191,685,2054,617,46,327,294,4472,1295,3799,498,1191,685,2054,617,46,327,294,4472
2024-10-14,19éû,4997,1314,3683,498,1071,737,2026,617,46,327,294,4376,1314,3683,498,1071,737,2026,617,46,327,294,4376
2024-10-14,19éûîº,5041,1325,3716,376,1283,800,1915,617,46,327,294,4419,1325,3716,376,1283,800,1915,617,46,327,294,4419
2024-10-14,20éû,4648,1125,3523,376,928,675,2004,617,46,122,294,4233,1125,3523,376,928,675,2004,617,46,122,294,4233
2024-10-14,20éûîº,4282,1364,2918,501,1015,563,1769,384,46,122,207,3953,1364,2918,501,1015,563,1769,384,46,122,207,3953
2024-10-14,21éû,2538,1029,1509,455,648,398,802,186,46,122,207,2209,1029,1509,455,648,398,802,186,46,122,207,2209
2024-10-14,21éûîº,2154,1030,1124,352,560,540,527,127,46,122,207,1825,1030,1124,352,560,540,527,127,46,122,207,1825
2024-10-14,22éû,1437,707,730,253,417,286,418,62,0,122,63,1251,707,730,253,417,286,418,62,0,122,63,1251
2024-10-14,22éûîº,1156,526,630,253,417,208,248,29,0,122,63,971,526,630,253,417,208,248,29,0,122,63,971
2024-10-14,23éû,599,118,481,0,216,208,175,0,0,92,63,443,118,481,0,216,208,175,0,0,92,63,443
2024-10-14,23éûîº,210,118,92,0,0,144,66,0,0,92,0,118,118,92,0,0,144,66,0,0,92,0,118
2024-10-14,24éû,109,109,0,0,0,51,27,29,0,29,0,79,109,0,0,0,51,27,29,0,29,0,79
2024-10-14,24éûîº,109,109,0,0,0,51,27,29,0,29,0,79,109,0,0,0,51,27,29,0,29,0,79
2024-10-14,25éû,57,57,0,0,0,0,27,29,0,29,0,27,57,0,0,0,0,27,29,0,29,0,27
2024-10-14,25éûîº,57,57,0,0,0,0,27,29,0,29,0,27,57,0,0,0,0,27,29,0,29,0,27
2024-10-14,26éû,88,88,0,0,0,0,58,29,0,29,0,58,88,0,0,0,0,58,29,0,29,0,58
2024-10-14,26éûîº,131,57,74,0,0,0,102,29,0,29,0,102,57,74,0,0,0,102,29,0,29,0,102
2024-10-14,27éû,131,57,74,0,0,0,102,29,0,29,0,102,57,74,0,0,0,102,29,0,29,0,102
2024-10-14,27éûîº,131,57,74,0,0,0,102,29,0,29,0,102,57,74,0,0,0,102,29,0,29,0,102
2024-10-14,28éû,131,57,74,0,0,0,102,29,0,29,0,102,57,74,0,0,0,102,29,0,29,0,102
2024-10-14,28éûîº,131,57,74,0,0,0,102,29,0,29,0,102,57,74,0,0,0,102,29,0,29,0,102
2024-10-15,5éû,0,0,0,0,0,0,0,0,0,0,0,0,0,0,0,0,0,0,0,0,0,0,0
2024-10-15,5éûîº,0,0,0,0,0,0,0,0,0,0,0,0,0,0,0,0,0,0,0,0,0,0,0
2024-10-15,6éû,31,31,0,0,0,0,31,0,0,0,0,31,31,0,0,0,0,31,0,0,0,0,31
2024-10-15,6éûîº,64,31,33,0,0,0,64,0,0,0,0,64,31,33,0,0,0,64,0,0,0,0,64
2024-10-15,7éû,278,33,245,212,0,0,33,0,33,0,0,279,33,245,212,0,0,33,0,33,0,0,279
2024-10-15,7éûîº,33,0,33,0,0,0,33,0,0,0,0,33,0,33,0,0,0,33,0,0,0,0,33
2024-10-15,8éû,151,61,90,0,90,61,0,0,0,61,90,0,61,90,0,90,61,0,0,0,61,90,0
2024-10-15,8éûîº,250,160,90,136,90,0,23,0,0,136,90,23,160,90,136,90,0,23,0,0,136,90,23
2024-10-15,9éû,259,169,90,136,90,0,33,0,0,136,90,33,169,90,136,90,0,33,0,0,136,90,33
2024-10-15,9éûîº,255,136,119,136,90,0,29,0,0,136,90,29,136,119,136,90,0,29,0,0,136,90,29
2024-10-15,10éû,210,28,182,0,90,62,58,0,0,0,90,120,28,182,0,90,62,58,0,0,0,90,120
2024-10-15,10éûîº,255,28,227,0,90,62,28,35,39,39,90,126,28,227,0,90,62,28,35,39,39,90,126
2024-10-15,11éû,283,101,182,0,90,132,28,0,33,33,90,160,101,182,0,90,132,28,0,33,33,90,160
2024-10-15,11éûîº,671,129,542,0,416,166,55,0,33,33,233,404,129,542,0,416,166,55,0,33,33,233,404
2024-10-15,12éû,748,224,524,0,505,165,44,0,33,33,90,625,224,524,0,505,165,44,0,33,33,90,625
2024-10-15,12éûîº,817,226,591,0,442,170,138,32,33,126,90,601,226,591,0,442,170,138,32,33,126,90,601
2024-10-15,13éû,780,126,654,0,353,131,200,62,33,126,90,565,126,654,0,353,131,200,62,33,126,90,565
2024-10-15,13éûîº,874,180,694,0,353,131,297,91,0,0,90,784,180,694,0,353,131,297,91,0,0,90,784
2024-10-15,14éû,1067,361,706,159,353,131,282,91,49,29,90,948,361,706,159,353,131,282,91,49,29,90,948
2024-10-15,14éûîº,1224,337,887,159,455,160,351,98,0,29,90,1105,337,887,159,455,160,351,98,0,29,90,1105
2024-10-15,15éû,1678,674,1004,159,455,309,608,146,0,29,90,1559,674,1004,159,455,309,608,146,0,29,90,1559
2024-10-15,15éûîº,1866,710,1156,159,455,309,815,127,0,0,90,1776,710,1156,159,455,309,815,127,0,0,90,1776
2024-10-15,16éû,2088,919,1169,159,455,399,850,111,112,0,90,1998,919,1169,159,455,399,850,111,112,0,90,1998
2024-10-15,16éûîº,2154,1020,1134,159,272,407,1059,144,112,33,90,2031,1020,1134,159,272,407,1059,144,112,33,90,2031
2024-10-15,17éû,2721,1253,1468,159,272,419,1485,242,142,63,90,2569,1253,1468,159,272,419,1485,242,142,63,90,2569
2024-10-15,17éûîº,3595,1644,1951,600,272,398,1887,364,71,0,90,3505,1644,1951,600,272,398,1887,364,71,0,90,3505
2024-10-15,18éû,3916,1782,2134,600,373,364,2138,383,56,0,191,3726,1782,2134,600,373,364,2138,383,56,0,191,3726
2024-10-15,18éûîº,4048,1680,2368,560,416,577,2060,412,22,269,90,3689,1680,2368,560,416,577,2060,412,22,269,90,3689
2024-10-15,19éû,3217,1350,1867,436,416,363,1598,380,22,176,90,2951,1350,1867,436,416,363,1598,380,22,176,90,2951
2024-10-15,19éûîº,3024,1410,1614,436,338,363,1483,381,22,29,90,2905,1410,1614,436,338,363,1483,381,22,29,90,2905
2024-10-15,20éû,2880,1338,1542,436,338,293,1438,351,22,0,90,2791,1338,1542,436,338,293,1438,351,22,0,90,2791
2024-10-15,20éûîº,2757,1215,1542,436,338,230,1409,321,22,0,90,2668,1215,1542,436,338,230,1409,321,22,0,90,2668
2024-10-15,21éû,3370,1613,1757,560,564,294,1537,391,22,0,172,3198,1613,1757,560,564,294,1537,391,22,0,172,3198
2024-10-15,21éûîº,2604,1158,1446,560,472,103,1196,249,22,0,82,2522,1158,1446,560,472,103,1196,249,22,0,82,2522
2024-10-15,22éû,1512,482,1030,436,246,39,612,156,22,0,0,1513,482,1030,436,246,39,612,156,22,0,0,1513
2024-10-15,22éûîº,1151,342,809,436,246,0,317,128,22,0,0,1151,342,809,436,246,0,317,128,22,0,0,1151
2024-10-15,23éû,705,286,419,436,0,0,150,97,22,0,0,706,286,419,436,0,0,150,97,22,0,0,706
2024-10-15,23éûîº,189,157,32,0,0,0,100,66,22,0,0,189,157,32,0,0,0,100,66,22,0,0,189
2024-10-15,24éû,35,35,0,0,0,0,35,0,0,0,0,35,35,0,0,0,0,35,0,0,0,0,35
2024-10-15,24éûîº,61,61,0,0,0,0,35,0,26,0,0,61,61,0,0,0,0,35,0,26,0,0,61
2024-10-15,25éû,35,35,0,0,0,0,35,0,0,0,0,35,35,0,0,0,0,35,0,0,0,0,35
2024-10-15,25éûîº,35,35,0,0,0,0,35,0,0,0,0,35,35,0,0,0,0,35,0,0,0,0,35
2024-10-15,26éû,35,35,0,0,0,0,35,0,0,0,0,35,35,0,0,0,0,35,0,0,0,0,35
2024-10-15,26éûîº,35,35,0,0,0,0,35,0,0,0,0,35,35,0,0,0,0,35,0,0,0,0,35
2024-10-15,27éû,35,35,0,0,0,0,35,0,0,0,0,35,35,0,0,0,0,35,0,0,0,0,35
2024-10-15,27éûîº,35,35,0,0,0,0,35,0,0,0,0,35,35,0,0,0,0,35,0,0,0,0,35
2024-10-15,28éû,35,35,0,0,0,0,35,0,0,0,0,35,35,0,0,0,0,35,0,0,0,0,35
2024-10-15,28éûîº,79,79,0,0,0,44,35,0,0,0,0,79,79,0,0,0,44,35,0,0,0,0,79
2024-10-16,5éû,0,0,0,0,0,0,0,0,0,0,0,0,0,0,0,0,0,0,0,0,0,0,0
2024-10-16,5éûîº,0,0,0,0,0,0,0,0,0,0,0,0,0,0,0,0,0,0,0,0,0,0,0
2024-10-16,6éû,32,32,0,0,0,0,32,0,0,0,0,32,32,0,0,0,0,32,0,0,0,0,32
2024-10-16,6éûîº,0,0,0,0,0,0,0,0,0,0,0,0,0,0,0,0,0,0,0,0,0,0,0
2024-10-16,7éû,0,0,0,0,0,0,0,0,0,0,0,0,0,0,0,0,0,0,0,0,0,0,0
2024-10-16,7éûîº,0,0,0,0,0,0,0,0,0,0,0,0,0,0,0,0,0,0,0,0,0,0,0
2024-10-16,8éû,0,0,0,0,0,0,0,0,0,0,0,0,0,0,0,0,0,0,0,0,0,0,0
2024-10-16,8éûîº,122,122,0,0,72,49,0,0,0,0,0,122,122,0,0,72,49,0,0,0,0,0,122
2024-10-16,9éû,324,144,180,0,216,71,37,0,0,0,180,144,144,180,0,216,71,37,0,0,0,180,144
2024-10-16,9éûîº,399,0,399,0,143,179,37,0,39,39,267,92,0,399,0,143,179,37,0,39,39,267,92
2024-10-16,10éû,684,285,399,0,216,293,102,0,73,101,319,264,285,399,0,216,293,102,0,73,101,319,264
2024-10-16,10éûîº,444,202,242,0,72,226,70,0,73,101,124,218,202,242,0,72,226,70,0,73,101,124,218
2024-10-16,11éû,537,374,163,0,72,200,128,62,73,131,209,197,374,163,0,72,200,128,62,73,131,209,197
2024-10-16,11éûîº,1263,455,808,0,400,413,111,147,191,131,472,659,455,808,0,400,413,111,147,191,131,472,659
2024-10-16,12éû,1059,292,767,0,400,299,58,144,157,39,387,632,292,767,0,400,299,58,144,157,39,387,632
2024-10-16,12éûîº,1403,505,898,0,516,517,99,113,157,69,386,948,505,898,0,516,517,99,113,157,69,386,948
2024-10-16,13éû,1264,532,732,155,206,484,99,55,262,73,360,831,532,732,155,206,484,99,55,262,73,360,831
2024-10-16,13éûîº,1415,576,839,521,206,420,61,55,150,39,296,1079,576,839,521,206,420,61,55,150,39,296,1079
2024-10-16,14éû,1382,463,919,521,350,301,35,63,111,29,228,1124,463,919,521,350,301,35,63,111,29,228,1124
2024-10-16,14éûîº,1128,532,596,155,403,241,117,65,144,0,292,836,532,596,155,403,241,117,65,144,0,292,836
2024-10-16,15éû,1413,698,715,155,553,480,117,65,39,0,292,1120,698,715,155,553,480,117,65,39,0,292,1120
2024-10-16,15éûîº,1855,817,1038,463,535,540,145,131,39,0,292,1562,817,1038,463,535,540,145,131,39,0,292,1562
2024-10-16,16éû,1631,772,859,586,291,480,168,65,39,0,292,1339,772,859,586,291,480,168,65,39,0,292,1339
2024-10-16,16éûîº,2001,829,1172,686,464,573,133,65,79,39,292,1670,829,1172,686,464,573,133,65,79,39,292,1670
2024-10-16,17éû,2934,1242,1692,1296,448,851,133,126,79,39,292,2602,1242,1692,1296,448,851,133,126,79,39,292,2602
2024-10-16,17éûîº,3348,1610,1738,1688,762,667,133,62,33,143,292,2912,1610,1738,1688,762,667,133,62,33,143,292,2912
2024-10-16,18éû,3140,1619,1521,1808,714,430,123,30,33,143,240,2756,1619,1521,1808,714,430,123,30,33,143,240,2756
2024-10-16,18éûîº,3051,1578,1473,1741,714,462,73,59,0,295,240,2515,1578,1473,1741,714,462,73,59,0,295,240,2515
2024-10-16,19éû,2734,1477,1257,1370,641,524,133,66,0,265,240,2228,1477,1257,1370,641,524,133,66,0,265,240,2228
2024-10-16,19éûîº,2570,1361,1209,1260,572,493,177,66,0,173,240,2157,1361,1209,1260,572,493,177,66,0,173,240,2157
2024-10-16,20éû,2681,1328,1353,1260,715,493,144,66,0,316,240,2124,1328,1353,1260,715,493,144,66,0,316,240,2124
2024-10-16,20éûîº,2689,1561,1128,1416,630,500,142,0,0,143,240,2306,1561,1128,1416,630,500,142,0,0,143,240,2306
2024-10-16,21éû,2243,1434,809,1250,662,233,97,0,0,143,154,1946,1434,809,1250,662,233,97,0,0,143,154,1946
2024-10-16,21éûîº,1445,869,576,1046,268,63,66,0,0,0,63,1381,869,576,1046,268,63,66,0,0,0,63,1381
2024-10-16,22éû,866,546,320,511,252,63,39,0,0,0,63,802,546,320,511,252,63,39,0,0,0,63,802
2024-10-16,22éûîº,503,183,320,256,183,63,0,0,0,0,63,439,183,320,256,183,63,0,0,0,0,63,439
2024-10-16,23éû,314,58,256,256,58,0,0,0,0,0,0,315,58,256,256,58,0,0,0,0,0,0,315
2024-10-16,23éûîº,256,0,256,256,0,0,0,0,0,0,0,256,0,256,256,0,0,0,0,0,0,0,256
2024-10-16,24éû,29,29,0,0,0,0,0,29,0,29,0,0,29,0,0,0,0,0,29,0,29,0,0
2024-10-16,24éûîº,29,29,0,0,0,0,0,29,0,29,0,0,29,0,0,0,0,0,29,0,29,0,0
2024-10-16,25éû,29,29,0,0,0,0,0,29,0,29,0,0,29,0,0,0,0,0,29,0,29,0,0
2024-10-16,25éûîº,29,29,0,0,0,0,0,29,0,29,0,0,29,0,0,0,0,0,29,0,29,0,0
2024-10-16,26éû,91,91,0,0,0,61,0,29,0,91,0,0,91,0,0,0,61,0,29,0,91,0,0
2024-10-16,26éûîº,91,91,0,0,0,61,0,29,0,91,0,0,91,0,0,0,61,0,29,0,91,0,0
2024-10-16,27éû,29,29,0,0,0,0,0,29,0,29,0,0,29,0,0,0,0,0,29,0,29,0,0
2024-10-16,27éûîº,78,78,0,0,0,49,0,29,0,29,0,49,78,0,0,0,49,0,29,0,29,0,49
2024-10-16,28éû,29,29,0,0,0,0,0,29,0,29,0,0,29,0,0,0,0,0,29,0,29,0,0
2024-10-16,28éûîº,29,29,0,0,0,0,0,29,0,29,0,0,29,0,0,0,0,0,29,0,29,0,0
2024-10-17,5éû,0,0,0,0,0,0,0,0,0,0,0,0,0,0,0,0,0,0,0,0,0,0,0
2024-10-17,5éûîº,0,0,0,0,0,0,0,0,0,0,0,0,0,0,0,0,0,0,0,0,0,0,0
2024-10-17,6éû,0,0,0,0,0,0,0,0,0,0,0,0,0,0,0,0,0,0,0,0,0,0,0
2024-10-17,6éûîº,0,0,0,0,0,0,0,0,0,0,0,0,0,0,0,0,0,0,0,0,0,0,0
2024-10-17,7éû,0,0,0,0,0,0,0,0,0,0,0,0,0,0,0,0,0,0,0,0,0,0,0
2024-10-17,7éûîº,0,0,0,0,0,0,0,0,0,0,0,0,0,0,0,0,0,0,0,0,0,0,0
2024-10-17,8éû,304,113,191,0,191,113,0,0,0,0,243,61,113,191,0,191,113,0,0,0,0,243,61
2024-10-17,8éûîº,180,51,129,0,90,51,39,0,0,0,141,39,51,129,0,90,51,39,0,0,0,141,39
2024-10-17,9éû,249,120,129,0,158,51,39,0,0,0,210,39,120,129,0,158,51,39,0,0,0,210,39
2024-10-17,9éûîº,210,120,90,0,158,51,0,0,0,0,210,0,120,90,0,158,51,0,0,0,0,210,0
2024-10-17,10éû,296,120,176,0,158,138,0,0,0,0,297,0,120,176,0,158,138,0,0,0,0,297,0
2024-10-17,10éûîº,686,153,533,0,341,273,32,0,39,39,297,350,153,533,0,341,273,32,0,39,39,297,350
2024-10-17,11éû,947,244,703,0,418,427,61,0,39,193,297,455,244,703,0,418,427,61,0,39,193,297,455
2024-10-17,11éûîº,1626,411,1215,256,561,489,172,29,116,255,440,930,411,1215,256,561,489,172,29,116,255,440,930
2024-10-17,12éû,1539,388,1151,256,561,477,135,29,80,163,455,921,388,1151,256,561,477,135,29,80,163,455,921
2024-10-17,12éûîº,1433,463,970,256,471,529,37,59,80,163,393,877,463,970,256,471,529,37,59,80,163,393,877
2024-10-17,13éû,1479,408,1071,256,572,469,37,30,114,135,494,849,408,1071,256,572,469,37,30,114,135,494,849
2024-10-17,13éûîº,1558,551,1007,378,578,396,61,30,112,135,376,1046,551,1007,378,578,396,61,30,112,135,376,1046
2024-10-17,14éû,1832,529,1303,378,578,580,144,37,112,135,346,1350,529,1303,378,578,580,144,37,112,135,346,1350
2024-10-17,14éûîº,1675,654,1021,211,578,488,180,103,112,135,346,1193,654,1021,211,578,488,180,103,112,135,346,1193
2024-10-17,15éû,1672,781,891,333,501,503,119,103,112,135,346,1190,781,891,333,501,503,119,103,112,135,346,1190
2024-10-17,15éûîº,1680,824,856,333,554,396,218,99,79,101,346,1233,824,856,333,554,396,218,99,79,101,346,1233
2024-10-17,16éû,1933,973,960,379,682,448,245,99,79,101,398,1433,973,960,379,682,448,245,99,79,101,398,1433
2024-10-17,16éûîº,1805,964,841,492,546,384,168,101,112,101,398,1306,964,841,492,546,384,168,101,112,101,398,1306
2024-10-17,17éû,2003,1081,922,492,546,554,203,129,79,101,398,1503,1081,922,492,546,554,203,129,79,101,398,1503
2024-10-17,17éûîº,2805,1291,1514,855,728,781,233,129,79,193,398,2214,1291,1514,855,728,781,233,129,79,193,398,2214
2024-10-17,18éû,2579,1125,1454,869,679,629,287,33,79,193,245,2139,1125,1454,869,679,629,287,33,79,193,245,2139
2024-10-17,18éûîº,2017,767,1250,652,591,382,212,66,111,134,245,1637,767,1250,652,591,382,212,66,111,134,245,1637
2024-10-17,19éû,1903,686,1217,517,674,382,184,33,111,134,245,1523,686,1217,517,674,382,184,33,111,134,245,1523
2024-10-17,19éûîº,1822,772,1050,653,424,382,187,63,111,334,155,1332,772,1050,653,424,382,187,63,111,334,155,1332
2024-10-17,20éû,1906,963,943,776,424,385,149,60,111,304,155,1447,963,943,776,424,385,149,60,111,304,155,1447
2024-10-17,20éûîº,1592,963,629,776,324,248,71,60,111,304,151,1137,963,629,776,324,248,71,60,111,304,151,1137
2024-10-17,21éû,1707,1144,563,781,434,244,102,33,111,304,151,1251,1144,563,781,434,244,102,33,111,304,151,1251
2024-10-17,21éûîº,1035,751,284,287,383,182,71,0,111,134,151,750,751,284,287,383,182,71,0,111,134,151,750
2024-10-17,22éû,863,541,322,159,383,133,76,0,111,101,151,610,541,322,159,383,133,76,0,111,101,151,610
2024-10-17,22éûîº,748,426,322,159,241,133,76,27,111,101,68,578,426,322,159,241,133,76,27,111,101,68,578
2024-10-17,23éû,428,240,188,0,180,133,76,0,39,101,68,259,240,188,0,180,133,76,0,39,101,68,259
2024-10-17,23éûîº,329,171,158,0,0,214,76,0,39,101,0,228,171,158,0,0,214,76,0,39,101,0,228
2024-10-17,24éû,147,29,118,0,0,81,37,29,0,29,0,118,29,118,0,0,81,37,29,0,29,0,118
2024-10-17,24éûîº,147,29,118,0,0,81,37,29,0,29,0,118,29,118,0,0,81,37,29,0,29,0,118
2024-10-17,25éû,81,0,81,0,0,81,0,0,0,0,0,81,0,81,0,0,81,0,0,0,0,0,81
2024-10-17,25éûîº,264,0,264,0,183,81,0,0,0,0,0,264,0,264,0,183,81,0,0,0,0,0,264
2024-10-17,26éû,264,0,264,0,183,81,0,0,0,0,0,264,0,264,0,183,81,0,0,0,0,0,264
2024-10-17,26éûîº,264,0,264,0,183,81,0,0,0,0,0,264,0,264,0,183,81,0,0,0,0,0,264
2024-10-17,27éû,81,0,81,0,0,81,0,0,0,0,0,81,0,81,0,0,81,0,0,0,0,0,81
2024-10-17,27éûîº,81,0,81,0,0,81,0,0,0,0,0,81,0,81,0,0,81,0,0,0,0,0,81
2024-10-17,28éû,81,0,81,0,0,81,0,0,0,0,0,81,0,81,0,0,81,0,0,0,0,0,81
2024-10-17,28éûîº,0,0,0,0,0,0,0,0,0,0,0,0,0,0,0,0,0,0,0,0,0,0,0
2024-10-18,5éû,37,37,0,0,0,37,0,0,0,0,0,37,37,0,0,0,37,0,0,0,0,0,37
2024-10-18,5éûîº,37,37,0,0,0,37,0,0,0,0,0,37,37,0,0,0,37,0,0,0,0,0,37
2024-10-18,6éû,37,37,0,0,0,37,0,0,0,0,0,37,37,0,0,0,37,0,0,0,0,0,37
2024-10-18,6éûîº,67,67,0,0,0,37,30,0,0,0,0,67,67,0,0,0,37,30,0,0,0,0,67
2024-10-18,7éû,99,99,0,0,0,99,0,0,0,61,0,37,99,0,0,0,99,0,0,0,61,0,37
2024-10-18,7éûîº,285,193,92,0,64,191,30,0,0,154,0,131,193,92,0,64,191,30,0,0,154,0,131
2024-10-18,8éû,332,240,92,0,64,191,30,0,46,92,46,193,240,92,0,64,191,30,0,46,92,46,193
2024-10-18,8éûîº,307,215,92,0,64,243,0,0,0,154,51,101,215,92,0,64,243,0,0,0,154,51,101
2024-10-18,9éû,345,215,130,0,64,243,37,0,0,154,89,101,215,130,0,64,243,37,0,0,154,89,101
2024-10-18,9éûîº,345,215,130,0,64,243,37,0,0,154,89,101,215,130,0,64,243,37,0,0,154,89,101
2024-10-18,10éû,347,217,130,0,64,246,37,0,0,154,37,155,217,130,0,64,246,37,0,0,154,37,155
2024-10-18,10éûîº,639,253,386,256,64,246,73,0,0,154,37,448,253,386,256,64,246,73,0,0,154,37,448
2024-10-18,11éû,1025,241,784,518,64,255,117,69,0,154,37,833,241,784,518,64,255,117,69,0,154,37,833
2024-10-18,11éûîº,1216,250,966,518,207,346,117,27,0,154,232,830,250,966,518,207,346,117,27,0,154,232,830
2024-10-18,12éû,1130,343,787,256,207,406,177,83,0,187,232,710,343,787,256,207,406,177,83,0,187,232,710
2024-10-18,12éûîº,1470,607,863,391,275,406,205,191,0,187,262,1020,607,863,391,275,406,205,191,0,187,262,1020
2024-10-18,13éû,1770,786,984,550,366,432,201,221,0,217,416,1136,786,984,550,366,432,201,221,0,217,416,1136
2024-10-18,13éûîº,2095,917,1178,550,579,592,245,127,0,246,488,1361,917,1178,550,579,592,245,127,0,246,488,1361
2024-10-18,14éû,2217,839,1378,527,690,506,313,178,0,216,488,1512,839,1378,527,690,506,313,178,0,216,488,1512
2024-10-18,14éûîº,2072,961,1111,271,779,444,362,185,29,187,450,1434,961,1111,271,779,444,362,185,29,187,450,1434
2024-10-18,15éû,2003,1033,970,159,715,547,277,241,63,217,450,1335,1033,970,159,715,547,277,241,63,217,450,1335
2024-10-18,15éûîº,2344,976,1368,159,934,717,285,184,63,187,450,1706,976,1368,159,934,717,285,184,63,187,450,1706
2024-10-18,16éû,2208,772,1436,159,828,724,194,237,63,154,450,1603,772,1436,159,828,724,194,237,63,154,450,1603
2024-10-18,16éûîº,2009,740,1269,159,760,600,163,262,63,154,450,1404,740,1269,159,760,600,163,262,63,154,450,1404
2024-10-18,17éû,1995,840,1155,159,582,764,212,243,33,154,450,1390,840,1155,159,582,764,212,243,33,154,450,1390
2024-10-18,17éûîº,1742,812,930,159,423,593,233,266,67,187,398,1157,812,930,159,423,593,233,266,67,187,398,1157
2024-10-18,18éû,1513,816,697,159,322,540,345,112,33,187,297,1029,816,697,159,322,540,345,112,33,187,297,1029
2024-10-18,18éûîº,1311,601,710,159,404,356,167,118,105,217,297,796,601,710,159,404,356,167,118,105,217,297,796
2024-10-18,19éû,1317,626,691,159,488,356,159,82,71,184,297,836,626,691,159,488,356,159,82,71,184,297,836
2024-10-18,19éûîº,1111,605,506,159,405,326,126,22,71,61,350,699,605,506,159,405,326,126,22,71,61,350,699
2024-10-18,20éû,1119,526,593,159,405,369,64,50,71,61,437,620,526,593,159,405,369,64,50,71,61,437,620
2024-10-18,20éûîº,946,440,506,159,405,229,31,50,71,61,297,587,440,506,159,405,229,31,50,71,61,297,587
2024-10-18,21éû,870,364,506,0,405,280,62,50,71,61,297,511,364,506,0,405,280,62,50,71,61,297,511
2024-10-18,21éûîº,712,327,385,0,315,275,0,50,71,61,207,443,327,385,0,315,275,0,50,71,61,207,443
2024-10-18,22éû,837,525,312,136,171,270,119,27,111,198,63,575,525,312,136,171,270,119,27,111,198,63,575
2024-10-18,22éûîº,787,458,329,0,88,319,205,62,111,61,0,726,458,329,0,88,319,205,62,111,61,0,726
2024-10-18,23éû,505,333,172,0,88,293,96,27,0,61,63,380,333,172,0,88,293,96,27,0,61,63,380
2024-10-18,23éûîº,266,266,0,0,88,148,0,29,0,91,0,174,266,0,0,88,148,0,29,0,91,0,174
2024-10-18,24éû,99,99,0,0,0,99,0,0,0,61,0,37,99,0,0,0,99,0,0,0,61,0,37
2024-10-18,24éûîº,37,37,0,0,0,37,0,0,0,0,0,37,37,0,0,0,37,0,0,0,0,0,37
2024-10-18,25éû,118,37,81,0,0,118,0,0,0,0,0,118,37,81,0,0,118,0,0,0,0,0,118
2024-10-18,25éûîº,118,37,81,0,0,118,0,0,0,0,0,118,37,81,0,0,118,0,0,0,0,0,118
2024-10-18,26éû,118,37,81,0,0,118,0,0,0,0,0,118,37,81,0,0,118,0,0,0,0,0,118
2024-10-18,26éûîº,180,99,81,0,0,180,0,0,0,61,0,118,99,81,0,0,180,0,0,0,61,0,118
2024-10-18,27éû,81,0,81,0,0,81,0,0,0,0,0,81,0,81,0,0,81,0,0,0,0,0,81
2024-10-18,27éûîº,81,0,81,0,0,81,0,0,0,0,0,81,0,81,0,0,81,0,0,0,0,0,81
2024-10-18,28éû,81,0,81,0,0,81,0,0,0,0,0,81,0,81,0,0,81,0,0,0,0,0,81
2024-10-18,28éûîº,37,37,0,0,0,37,0,0,0,0,0,37,37,0,0,0,37,0,0,0,0,0,37
2024-10-19,5éû,0,0,0,0,0,0,0,0,0,0,0,0,0,0,0,0,0,0,0,0,0,0,0
2024-10-19,5éûîº,31,0,31,0,0,0,31,0,0,0,0,31,0,31,0,0,0,31,0,0,0,0,31
2024-10-19,6éû,31,0,31,0,0,0,31,0,0,0,0,31,0,31,0,0,0,31,0,0,0,0,31
2024-10-19,6éûîº,90,27,63,0,0,0,31,60,0,0,0,91,27,63,0,0,0,31,60,0,0,0,91
2024-10-19,7éû,58,27,31,0,0,0,31,27,0,0,0,58,27,31,0,0,0,31,27,0,0,0,58
2024-10-19,7éûîº,27,27,0,0,0,0,0,27,0,0,0,27,27,0,0,0,0,0,27,0,0,0,27
2024-10-19,8éû,278,135,143,0,143,49,58,27,0,143,0,135,135,143,0,143,49,58,27,0,143,0,135
2024-10-19,8éûîº,281,77,204,0,143,49,68,20,0,143,0,138,77,204,0,143,49,68,20,0,143,0,138
2024-10-19,9éû,264,27,237,0,143,0,68,52,0,143,0,121,27,237,0,143,0,68,52,0,143,0,121
2024-10-19,9éûîº,561,97,464,233,0,234,47,0,46,0,0,562,97,464,233,0,234,47,0,46,0,0,562
2024-10-19,10éû,1223,319,904,233,530,346,73,0,39,101,0,1122,319,904,233,530,346,73,0,39,101,0,1122
2024-10-19,10éûîº,1531,428,1103,233,599,455,203,0,39,101,0,1430,428,1103,233,599,455,203,0,39,101,0,1430
2024-10-19,11éû,1996,577,1419,233,657,757,247,60,39,101,0,1894,577,1419,233,657,757,247,60,39,101,0,1894
2024-10-19,11éûîº,2171,706,1465,233,818,671,240,152,56,61,0,2110,706,1465,233,818,671,240,152,56,61,0,2110
2024-10-19,12éû,2441,987,1454,233,1000,705,294,152,56,61,0,2380,987,1454,233,1000,705,294,152,56,61,0,2380
2024-10-19,12éûîº,3116,1655,1461,500,963,922,414,260,56,184,63,2868,1655,1461,500,963,922,414,260,56,184,63,2868
2024-10-19,13éû,3122,1767,1355,500,781,1017,506,227,89,184,165,2773,1767,1355,500,781,1017,506,227,89,184,165,2773
2024-10-19,13éûîº,3744,2055,1689,500,1041,1464,439,264,33,184,165,3395,2055,1689,500,1041,1464,439,264,33,184,165,3395
2024-10-19,14éû,3609,2038,1571,748,825,1350,409,240,33,154,165,3290,2038,1571,748,825,1350,409,240,33,154,165,3290
2024-10-19,14éûîº,3182,1762,1420,617,857,1044,420,208,33,154,205,2823,1762,1420,617,857,1044,420,208,33,154,205,2823
2024-10-19,15éû,3720,1897,1823,799,1053,1311,425,131,0,246,165,3309,1897,1823,799,1053,1311,425,131,0,246,165,3309
2024-10-19,15éûîº,3271,1709,1562,675,976,1140,346,133,0,154,165,2952,1709,1562,675,976,1140,346,133,0,154,165,2952
2024-10-19,16éû,3601,2140,1461,982,1346,753,377,141,0,154,165,3282,2140,1461,982,1346,753,377,141,0,154,165,3282
2024-10-19,16éûîº,4513,2876,1637,1848,1375,612,535,141,0,61,101,4350,2876,1637,1848,1375,612,535,141,0,61,101,4350
2024-10-19,17éû,5395,3541,1854,2470,1629,675,445,174,0,205,101,5089,3541,1854,2470,1629,675,445,174,0,205,101,5089
2024-10-19,17éûîº,5157,3490,1667,2455,1335,782,341,205,37,238,165,4754,3490,1667,2455,1335,782,341,205,37,238,165,4754
2024-10-19,18éû,4139,2864,1275,1791,967,845,292,205,37,238,63,3837,2864,1275,1791,967,845,292,205,37,238,63,3837
2024-10-19,18éûîº,3763,2708,1055,1937,684,753,245,105,37,61,63,3637,2708,1055,1937,684,753,245,105,37,61,63,3637
2024-10-19,19éû,4159,2865,1294,1937,822,910,271,138,78,154,63,3941,2865,1294,1937,822,910,271,138,78,154,63,3941
2024-10-19,19éûîº,4577,3307,1270,1937,1062,849,469,170,88,154,63,4360,3307,1270,1937,1062,849,469,170,88,154,63,4360
2024-10-19,20éû,5108,3709,1399,2209,1102,899,568,240,88,198,150,4759,3709,1399,2209,1102,899,568,240,88,198,150,4759
2024-10-19,20éûîº,3898,2766,1132,1234,1057,851,443,273,37,61,150,3686,2766,1132,1234,1057,851,443,273,37,61,150,3686
2024-10-19,21éû,2934,1628,1306,1046,980,485,254,131,37,61,63,2808,1628,1306,1046,980,485,254,131,37,61,63,2808
2024-10-19,21éûîº,2243,1125,1118,775,814,379,137,99,37,144,63,2035,1125,1118,775,814,379,137,99,37,144,63,2035
2024-10-19,22éû,1567,651,916,539,606,285,26,44,66,144,63,1359,651,916,539,606,285,26,44,66,144,63,1359
2024-10-19,22éûîº,1076,406,670,416,312,237,0,44,66,144,63,868,406,670,416,312,237,0,44,66,144,63,868
2024-10-19,23éû,570,191,379,256,85,147,0,44,37,61,0,508,191,379,256,85,147,0,44,37,61,0,508
2024-10-19,23éûîº,850,191,659,536,85,147,0,44,37,61,0,788,191,659,536,85,147,0,44,37,61,0,788
2024-10-19,24éû,187,102,85,0,85,102,0,0,0,61,0,125,102,85,0,85,102,0,0,0,61,0,125
2024-10-19,24éûîº,125,40,85,0,85,40,0,0,0,0,0,125,40,85,0,85,40,0,0,0,0,0,125
2024-10-19,25éû,125,40,85,0,85,40,0,0,0,0,0,125,40,85,0,85,40,0,0,0,0,0,125
2024-10-19,25éûîº,125,40,85,0,85,40,0,0,0,0,0,125,40,85,0,85,40,0,0,0,0,0,125
2024-10-19,26éû,85,0,85,0,85,0,0,0,0,0,0,85,0,85,0,85,0,0,0,0,0,0,85
2024-10-19,26éûîº,85,0,85,0,85,0,0,0,0,0,0,85,0,85,0,85,0,0,0,0,0,0,85
2024-10-19,27éû,85,0,85,0,85,0,0,0,0,0,0,85,0,85,0,85,0,0,0,0,0,0,85
2024-10-19,27éûîº,85,0,85,0,85,0,0,0,0,0,0,85,0,85,0,85,0,0,0,0,0,0,85
2024-10-19,28éû,85,0,85,0,85,0,0,0,0,0,0,85,0,85,0,85,0,0,0,0,0,0,85
2024-10-19,28éûîº,85,0,85,0,85,0,0,0,0,0,0,85,0,85,0,85,0,0,0,0,0,0,85
2024-10-20,5éû,212,212,0,130,82,0,0,0,0,82,0,130,212,0,130,82,0,0,0,0,82,0,130
2024-10-20,5éûîº,212,212,0,130,82,0,0,0,0,82,0,130,212,0,130,82,0,0,0,0,82,0,130
2024-10-20,6éû,137,137,0,0,82,54,0,0,0,82,0,54,137,0,0,82,54,0,0,0,82,0,54
2024-10-20,6éûîº,137,137,0,0,82,54,0,0,0,82,0,54,137,0,0,82,54,0,0,0,82,0,54
2024-10-20,7éû,146,146,0,0,82,37,0,26,0,82,0,63,146,0,0,82,37,0,26,0,82,0,63
2024-10-20,7éûîº,166,119,47,0,82,37,0,47,0,82,0,84,119,47,0,82,37,0,47,0,82,0,84
2024-10-20,8éû,228,181,47,0,144,37,0,47,0,82,61,84,181,47,0,144,37,0,47,0,82,61,84
2024-10-20,8éûîº,259,212,47,0,144,37,31,47,0,82,61,115,212,47,0,144,37,31,47,0,82,61,115
2024-10-20,9éû,471,424,47,159,151,37,33,91,0,82,68,320,424,47,159,151,37,33,91,0,82,68,320
2024-10-20,9éûîº,534,400,134,159,151,123,53,47,0,82,155,296,400,134,159,151,123,53,47,0,82,155,296
2024-10-20,10éû,919,713,206,159,515,123,70,51,0,82,155,681,713,206,159,515,123,70,51,0,82,155,681
2024-10-20,10éûîº,1404,1066,338,258,515,387,95,107,39,368,155,880,1066,338,258,515,387,95,107,39,368,155,880
2024-10-20,11éû,1872,1126,746,453,704,509,55,150,0,502,155,1216,1126,746,453,704,509,55,150,0,502,155,1216
2024-10-20,11éûîº,2376,1201,1175,453,976,663,88,116,79,347,155,1874,1201,1175,453,976,663,88,116,79,347,155,1874
2024-10-20,12éû,2617,1123,1494,686,936,631,93,193,79,409,155,2053,1123,1494,686,936,631,93,193,79,409,155,2053
2024-10-20,12éûîº,3108,1422,1686,955,972,757,133,162,127,326,155,2627,1422,1686,955,972,757,133,162,127,326,155,2627
2024-10-20,13éû,3729,1860,1869,1263,1050,838,219,232,125,297,309,3123,1860,1869,1263,1050,838,219,232,125,297,309,3123
2024-10-20,13éûîº,4201,2197,2004,1445,1452,692,254,232,125,336,309,3555,2197,2004,1445,1452,692,254,232,125,336,309,3555
2024-10-20,14éû,3878,2137,1741,1212,1398,735,255,191,85,336,309,3232,2137,1741,1212,1398,735,255,191,85,336,309,3232
2024-10-20,14éûîº,4174,2011,2163,1312,1614,649,358,154,85,274,309,3590,2011,2163,1312,1614,649,358,154,85,274,309,3590
2024-10-20,15éû,4723,2613,2110,1768,1733,715,357,148,0,235,371,4116,2613,2110,1768,1733,715,357,148,0,235,371,4116
2024-10-20,15éûîº,4488,2354,2134,1339,1810,918,238,183,0,235,309,3944,2354,2134,1339,1810,918,238,183,0,235,309,3944
2024-10-20,16éû,5301,2943,2358,1942,1916,924,336,180,0,235,309,4756,2943,2358,1942,1916,924,336,180,0,235,309,4756
2024-10-20,16éûîº,5291,3038,2253,1817,2091,871,297,214,0,235,309,4747,3038,2253,1817,2091,871,297,214,0,235,309,4747
2024-10-20,17éû,5635,3528,2107,2524,1749,859,285,189,26,235,309,5090,3528,2107,2524,1749,859,285,189,26,235,309,5090
2024-10-20,17éûîº,5284,3493,1791,2340,1625,748,344,153,73,235,309,4740,3493,1791,2340,1625,748,344,153,73,235,309,4740
2024-10-20,18éû,4410,3050,1360,1934,1175,696,377,153,73,297,309,3804,3050,1360,1934,1175,696,377,153,73,297,309,3804
2024-10-20,18éûîº,4069,3060,1009,1812,1128,568,305,181,73,91,309,3668,3060,1009,1812,1128,568,305,181,73,91,309,3668
2024-10-20,19éû,3669,2746,923,1695,1045,511,219,123,73,61,309,3298,2746,923,1695,1045,511,219,123,73,61,309,3298
2024-10-20,19éûîº,3588,2725,863,1734,964,450,254,157,26,95,309,3183,2725,863,1734,964,450,254,157,26,95,309,3183
2024-10-20,20éû,3658,2725,933,1734,964,520,254,157,26,95,309,3253,2725,933,1734,964,520,254,157,26,95,309,3253
2024-10-20,20éûîº,3715,2872,843,1665,850,734,308,129,26,128,219,3367,2872,843,1665,850,734,308,129,26,128,219,3367
2024-10-20,21éû,3279,2355,924,1593,791,584,214,68,26,128,219,2931,2355,924,1593,791,584,214,68,26,128,219,2931
2024-10-20,21éûîº,1364,1034,330,792,181,295,33,35,26,95,132,1137,1034,330,792,181,295,33,35,26,95,132,1137
2024-10-20,22éû,1013,753,260,655,119,176,0,35,26,61,132,818,753,260,655,119,176,0,35,26,61,132,818
2024-10-20,22éûîº,798,574,224,527,68,176,0,0,26,61,132,604,574,224,527,68,176,0,0,26,61,132,604
2024-10-20,23éû,352,192,160,353,0,0,0,0,0,0,0,353,192,160,353,0,0,0,0,0,0,0,353
2024-10-20,23éûîº,418,258,160,419,0,0,0,0,0,0,0,419,258,160,419,0,0,0,0,0,0,0,419
2024-10-20,24éû,196,196,0,196,0,0,0,0,0,0,0,196,196,0,196,0,0,0,0,0,0,0,196
2024-10-20,24éûîº,196,196,0,196,0,0,0,0,0,0,0,196,196,0,196,0,0,0,0,0,0,0,196
2024-10-20,25éû,130,130,0,130,0,0,0,0,0,0,0,130,130,0,130,0,0,0,0,0,0,0,130
2024-10-20,25éûîº,196,196,0,196,0,0,0,0,0,0,0,196,196,0,196,0,0,0,0,0,0,0,196
2024-10-20,26éû,242,242,0,130,82,0,0,29,0,112,0,130,242,0,130,82,0,0,29,0,112,0,130
2024-10-20,26éûîº,242,242,0,130,82,0,0,29,0,112,0,130,242,0,130,82,0,0,29,0,112,0,130
2024-10-20,27éû,242,242,0,130,82,0,0,29,0,112,0,130,242,0,130,82,0,0,29,0,112,0,130
2024-10-20,27éûîº,212,212,0,130,82,0,0,0,0,82,0,130,212,0,130,82,0,0,0,0,82,0,130
2024-10-20,28éû,212,212,0,130,82,0,0,0,0,82,0,130,212,0,130,82,0,0,0,0,82,0,130
2024-10-20,28éûîº,212,212,0,130,82,0,0,0,0,82,0,130,212,0,130,82,0,0,0,0,82,0,130
2024-10-21,5éû,0,0,0,0,0,0,0,0,0,0,0,0,0,0,0,0,0,0,0,0,0,0,0
2024-10-21,5éûîº,49,0,49,0,0,0,49,0,0,0,0,49,0,49,0,0,0,49,0,0,0,0,49
2024-10-21,6éû,144,95,49,0,68,0,49,27,0,0,0,145,95,49,0,68,0,49,27,0,0,0,145
2024-10-21,6éûîº,174,125,49,0,68,0,106,0,0,0,0,175,125,49,0,68,0,106,0,0,0,0,175
2024-10-21,7éû,145,96,49,0,68,0,77,0,0,0,0,146,96,49,0,68,0,77,0,0,0,0,146
2024-10-21,7éûîº,169,120,49,0,68,51,49,0,0,0,51,118,120,49,0,68,51,49,0,0,0,51,118
2024-10-21,8éû,251,150,101,0,169,51,30,0,0,0,153,99,150,101,0,169,51,30,0,0,0,153,99
2024-10-21,8éûîº,472,281,191,130,259,51,30,0,0,0,243,229,281,191,130,259,51,30,0,0,0,243,229
2024-10-21,9éû,608,417,191,266,259,51,30,0,0,0,243,365,417,191,266,259,51,30,0,0,0,243,365
2024-10-21,9éûîº,472,281,191,130,259,51,30,0,0,0,243,229,281,191,130,259,51,30,0,0,0,243,229
2024-10-21,10éû,486,246,240,130,191,51,79,0,33,0,243,243,246,240,130,191,51,79,0,33,0,243,243
2024-10-21,10éûîº,615,342,273,130,191,51,79,92,70,63,243,309,342,273,130,191,51,79,92,70,63,243,309
2024-10-21,11éû,837,430,407,130,334,100,99,63,109,33,243,561,430,407,130,334,100,99,63,109,33,243,561
2024-10-21,11éûîº,1385,546,839,370,417,172,167,99,159,33,243,1109,546,839,370,417,172,167,99,159,33,243,1109
2024-10-21,12éû,1247,473,774,370,334,80,197,156,108,63,243,941,473,774,370,334,80,197,156,108,63,243,941
2024-10-21,12éûîº,1390,642,748,459,338,51,192,201,146,63,243,1083,642,748,459,338,51,192,201,146,63,243,1083
2024-10-21,13éû,1258,476,782,328,335,51,224,172,146,33,243,982,476,782,328,335,51,224,172,146,33,243,982
2024-10-21,13éûîº,1248,323,925,240,479,51,160,172,146,0,243,1006,323,925,240,479,51,160,172,146,0,243,1006
2024-10-21,14éû,1151,293,858,240,479,51,95,138,146,0,243,908,293,858,240,479,51,95,138,146,0,243,908
2024-10-21,14éûîº,1308,368,940,376,560,51,64,108,148,136,243,930,368,940,376,560,51,64,108,148,136,243,930
2024-10-21,15éû,1642,593,1049,527,560,251,63,92,148,136,243,1263,593,1049,527,560,251,63,92,148,136,243,1263
2024-10-21,15éûîº,1790,884,906,789,416,251,63,122,148,166,243,1381,884,906,789,416,251,63,122,148,166,243,1381
2024-10-21,16éû,1687,814,873,789,416,251,26,92,111,136,243,1308,814,873,789,416,251,26,92,111,136,243,1308
2024-10-21,16éûîº,1386,674,712,548,416,144,26,92,158,215,243,928,674,712,548,416,144,26,92,158,215,243,928
2024-10-21,17éû,985,528,457,286,238,101,74,126,158,289,243,453,528,457,286,238,101,74,126,158,289,243,453
2024-10-21,17éûîº,920,530,390,286,101,194,81,144,112,342,153,425,530,390,286,101,194,81,144,112,342,153,425
2024-10-21,18éû,508,233,275,136,0,157,81,99,33,303,0,205,233,275,136,0,157,81,99,33,303,0,205
2024-10-21,18éûîº,598,233,365,136,182,65,81,99,33,210,0,388,233,365,136,182,65,81,99,33,210,0,388
2024-10-21,19éû,819,259,560,136,321,157,77,126,0,210,0,608,259,560,136,321,157,77,126,0,210,0,608
2024-10-21,19éûîº,793,231,562,267,321,127,77,0,0,276,0,517,231,562,267,321,127,77,0,0,276,0,517
2024-10-21,20éû,555,169,386,136,321,65,33,0,0,169,0,386,169,386,136,321,65,33,0,0,169,0,386
2024-10-21,20éûîº,828,261,567,136,567,61,33,29,0,199,0,629,261,567,136,567,61,33,29,0,199,0,629
2024-10-21,21éû,919,352,567,136,691,61,0,29,0,166,82,670,352,567,136,691,61,0,29,0,166,82,670
2024-10-21,21éûîº,705,177,528,136,569,0,0,0,0,136,143,426,177,528,136,569,0,0,0,0,136,143,426
2024-10-21,22éû,315,177,138,136,180,0,0,0,0,136,0,180,177,138,136,180,0,0,0,0,136,0,180
2024-10-21,22éûîº,138,0,138,0,138,0,0,0,0,0,0,138,0,138,0,138,0,0,0,0,0,0,138
2024-10-21,23éû,274,136,138,136,138,0,0,0,0,136,0,138,136,138,136,138,0,0,0,0,136,0,138
2024-10-21,23éûîº,274,136,138,136,138,0,0,0,0,136,0,138,136,138,136,138,0,0,0,0,136,0,138
2024-10-21,24éû,274,136,138,136,138,0,0,0,0,136,0,138,136,138,136,138,0,0,0,0,136,0,138
2024-10-21,24éûîº,274,136,138,136,138,0,0,0,0,136,0,138,136,138,136,138,0,0,0,0,136,0,138
2024-10-21,25éû,138,0,138,0,138,0,0,0,0,0,0,138,0,138,0,138,0,0,0,0,0,0,138
2024-10-21,25éûîº,220,82,138,0,221,0,0,0,0,82,0,138,82,138,0,221,0,0,0,0,82,0,138
2024-10-21,26éû,220,82,138,0,221,0,0,0,0,82,0,138,82,138,0,221,0,0,0,0,82,0,138
2024-10-21,26éûîº,289,151,138,0,290,0,0,0,0,82,0,207,151,138,0,290,0,0,0,0,82,0,207
2024-10-21,27éû,82,82,0,0,82,0,0,0,0,82,0,0,82,0,0,82,0,0,0,0,82,0,0
2024-10-21,27éûîº,82,82,0,0,82,0,0,0,0,82,0,0,82,0,0,82,0,0,0,0,82,0,0
2024-10-21,28éû,82,82,0,0,82,0,0,0,0,82,0,0,82,0,0,82,0,0,0,0,82,0,0
2024-10-21,28éûîº,82,82,0,0,82,0,0,0,0,82,0,0,82,0,0,82,0,0,0,0,82,0,0
2024-10-22,5éû,0,0,0,0,0,0,0,0,0,0,0,0,0,0,0,0,0,0,0,0,0,0,0
2024-10-22,5éûîº,0,0,0,0,0,0,0,0,0,0,0,0,0,0,0,0,0,0,0,0,0,0,0
2024-10-22,6éû,23,23,0,0,0,0,23,0,0,0,0,23,23,0,0,0,0,23,0,0,0,0,23
2024-10-22,6éûîº,31,31,0,0,0,0,31,0,0,0,0,31,31,0,0,0,0,31,0,0,0,0,31
2024-10-22,7éû,149,95,54,0,0,51,43,0,54,0,106,43,95,54,0,0,51,43,0,54,0,106,43
2024-10-22,7éûîº,110,110,0,0,58,51,0,0,0,0,51,58,110,0,0,58,51,0,0,0,0,51,58
2024-10-22,8éû,200,110,90,0,148,51,0,0,0,0,141,58,110,90,0,148,51,0,0,0,0,141,58
2024-10-22,8éûîº,275,141,134,0,148,51,75,0,0,0,141,133,141,134,0,148,51,75,0,0,0,141,133
2024-10-22,9éû,357,234,123,0,241,51,31,33,0,0,141,215,234,123,0,241,51,31,33,0,0,141,215
2024-10-22,9éûîº,314,191,123,0,183,98,0,33,0,0,141,172,191,123,0,183,98,0,33,0,0,141,172
2024-10-22,10éû,456,256,200,0,183,98,0,137,37,0,141,315,256,200,0,183,98,0,137,37,0,141,315
2024-10-22,10éûîº,409,215,194,0,183,108,0,79,39,39,141,228,215,194,0,183,108,0,79,39,39,141,228
2024-10-22,11éû,625,345,280,0,183,147,115,98,80,33,141,449,345,280,0,183,147,115,98,80,33,141,449
2024-10-22,11éûîº,1052,290,762,0,572,256,44,98,80,33,285,733,290,762,0,572,256,44,98,80,33,285,733
2024-10-22,12éû,1323,469,854,0,718,348,77,98,80,33,285,1004,469,854,0,718,348,77,98,80,33,285,1004
2024-10-22,12éûîº,1229,720,509,0,551,256,208,135,79,33,315,880,720,509,0,551,256,208,135,79,33,315,880
2024-10-22,13éû,1062,567,495,0,405,320,69,188,79,33,315,713,567,495,0,405,320,69,188,79,33,315,713
2024-10-22,13éûîº,885,433,452,0,405,172,119,144,45,0,335,551,433,452,0,405,172,119,144,45,0,335,551
2024-10-22,14éû,848,367,481,0,405,148,114,135,45,29,283,535,367,481,0,405,148,114,135,45,29,283,535
2024-10-22,14éûîº,668,320,348,0,326,56,122,163,0,29,283,356,320,348,0,326,56,122,163,0,29,283,356
2024-10-22,15éû,971,619,352,159,386,165,122,137,0,29,335,606,619,352,159,386,165,122,137,0,29,335,606
2024-10-22,15éûîº,877,502,375,159,326,109,113,169,0,29,285,563,502,375,159,326,109,113,169,0,29,285,563
2024-10-22,16éû,1407,661,746,399,395,335,113,130,32,29,285,1092,661,746,399,395,335,113,130,32,29,285,1092
2024-10-22,16éûîº,1322,596,726,399,395,264,35,194,32,29,285,1007,596,726,399,395,264,35,194,32,29,285,1007
2024-10-22,17éû,1273,613,660,399,395,282,35,128,32,91,285,896,613,660,399,395,282,35,128,32,91,285,896
2024-10-22,17éûîº,1052,461,591,399,304,118,0,158,71,29,0,1023,461,591,399,304,118,0,158,71,29,0,1023
2024-10-22,18éû,614,473,141,159,229,51,33,69,71,0,68,546,473,141,159,229,51,33,69,71,0,68,546
2024-10-22,18éûîº,608,434,174,159,161,113,0,102,71,33,0,575,434,174,159,161,113,0,102,71,33,0,575
2024-10-22,19éû,791,496,295,349,161,175,0,33,71,61,0,729,496,295,349,161,175,0,33,71,61,0,729
2024-10-22,19éûîº,843,395,448,349,93,220,0,63,118,29,0,814,395,448,349,93,220,0,63,118,29,0,814
2024-10-22,20éû,824,422,402,349,93,220,26,63,71,0,0,824,422,402,349,93,220,26,63,71,0,0,824
2024-10-22,20éûîº,661,366,295,349,93,113,0,33,71,0,0,661,366,295,349,93,113,0,33,71,0,0,661
2024-10-22,21éû,541,470,71,295,0,174,0,0,71,0,0,542,470,71,295,0,174,0,0,71,0,0,542
2024-10-22,21éûîº,113,113,0,0,0,113,0,0,0,0,0,113,113,0,0,0,113,0,0,0,0,0,113
2024-10-22,22éû,113,113,0,0,0,113,0,0,0,0,0,113,113,0,0,0,113,0,0,0,0,0,113
2024-10-22,22éûîº,150,150,0,0,68,51,0,29,0,29,0,120,150,0,0,68,51,0,29,0,29,0,120
2024-10-22,23éû,0,0,0,0,0,0,0,0,0,0,0,0,0,0,0,0,0,0,0,0,0,0,0
2024-10-22,23éûîº,68,68,0,0,68,0,0,0,0,0,0,68,68,0,0,68,0,0,0,0,0,0,68
2024-10-22,24éû,0,0,0,0,0,0,0,0,0,0,0,0,0,0,0,0,0,0,0,0,0,0,0
2024-10-22,24éûîº,50,50,0,0,50,0,0,0,0,0,0,50,50,0,0,50,0,0,0,0,0,0,50
2024-10-22,25éû,50,50,0,0,50,0,0,0,0,0,0,50,50,0,0,50,0,0,0,0,0,0,50
2024-10-22,25éûîº,148,148,0,148,0,0,0,0,0,0,0,148,148,0,148,0,0,0,0,0,0,0,148
2024-10-22,26éû,148,148,0,148,0,0,0,0,0,0,0,148,148,0,148,0,0,0,0,0,0,0,148
2024-10-22,26éûîº,0,0,0,0,0,0,0,0,0,0,0,0,0,0,0,0,0,0,0,0,0,0,0
2024-10-22,27éû,0,0,0,0,0,0,0,0,0,0,0,0,0,0,0,0,0,0,0,0,0,0,0
2024-10-22,27éûîº,0,0,0,0,0,0,0,0,0,0,0,0,0,0,0,0,0,0,0,0,0,0,0
2024-10-22,28éû,0,0,0,0,0,0,0,0,0,0,0,0,0,0,0,0,0,0,0,0,0,0,0
2024-10-22,28éûîº,28,28,0,0,0,0,0,0,28,0,0,28,28,0,0,0,0,0,0,28,0,0,28
2024-10-23,5éû,0,0,0,0,0,0,0,0,0,0,0,0,0,0,0,0,0,0,0,0,0,0,0
2024-10-23,5éûîº,0,0,0,0,0,0,0,0,0,0,0,0,0,0,0,0,0,0,0,0,0,0,0
2024-10-23,6éû,34,0,34,0,0,0,0,34,0,0,0,34,0,34,0,0,0,0,34,0,0,0,34
2024-10-23,6éûîº,28,28,0,0,0,0,28,0,0,0,0,28,28,0,0,0,0,28,0,0,0,0,28
2024-10-23,7éû,0,0,0,0,0,0,0,0,0,0,0,0,0,0,0,0,0,0,0,0,0,0,0
2024-10-23,7éûîº,51,51,0,0,0,51,0,0,0,0,51,0,51,0,0,0,51,0,0,0,0,51,0
2024-10-23,8éû,152,51,101,0,101,51,0,0,0,0,153,0,51,101,0,101,51,0,0,0,0,153,0
2024-10-23,8éûîº,183,82,101,0,101,51,31,0,0,0,153,31,82,101,0,101,51,31,0,0,0,153,31
2024-10-23,9éû,343,205,138,0,194,112,37,0,0,0,190,153,205,138,0,194,112,37,0,0,0,190,153
2024-10-23,9éûîº,533,242,291,0,194,266,73,0,0,0,252,281,242,291,0,194,266,73,0,0,0,252,281
2024-10-23,10éû,1034,524,510,0,290,500,140,29,73,0,339,695,524,510,0,290,500,140,29,73,0,339,695
2024-10-23,10éûîº,836,403,433,0,293,229,151,90,73,0,277,559,403,433,0,293,229,151,90,73,0,277,559
2024-10-23,11éû,951,488,463,0,293,274,183,93,107,33,277,641,488,463,0,293,274,183,93,107,33,277,641
2024-10-23,11éûîº,742,363,379,0,237,274,103,93,33,33,277,432,363,379,0,237,274,103,93,33,33,277,432
2024-10-23,12éû,1049,591,458,0,257,536,70,112,73,33,314,701,591,458,0,257,536,70,112,73,33,314,701
2024-10-23,12éûîº,1171,569,602,0,337,580,37,142,73,33,344,793,569,602,0,337,580,37,142,73,33,344,793
2024-10-23,13éû,1291,562,729,0,337,620,37,145,150,33,307,950,562,729,0,337,620,37,145,150,33,307,950
2024-10-23,13éûîº,1161,572,589,0,309,692,68,91,0,0,176,985,572,589,0,309,692,68,91,0,0,176,985
2024-10-23,14éû,1344,650,694,0,378,708,101,156,0,0,277,1067,650,694,0,378,708,101,156,0,0,277,1067
2024-10-23,14éûîº,1335,706,629,0,460,572,108,193,0,0,239,1096,706,629,0,460,572,108,193,0,0,239,1096
2024-10-23,15éû,1294,665,629,0,460,592,77,164,0,0,239,1055,665,629,0,460,592,77,164,0,0,239,1055
2024-10-23,15éûîº,1240,575,665,0,460,528,116,135,0,0,239,1001,575,665,0,460,528,116,135,0,0,239,1001
2024-10-23,16éû,1470,609,861,268,402,572,121,105,0,0,239,1231,609,861,268,402,572,121,105,0,0,239,1231
2024-10-23,16éûîº,1528,671,857,268,402,649,77,131,0,0,239,1289,671,857,268,402,649,77,131,0,0,239,1289
2024-10-23,17éû,1189,624,565,0,324,649,145,69,0,0,239,949,624,565,0,324,649,145,69,0,0,239,949
2024-10-23,17éûîº,1147,578,569,0,324,649,37,93,43,0,239,908,578,569,0,324,649,37,93,43,0,239,908
2024-10-23,18éû,1262,554,708,0,467,649,0,103,43,176,239,846,554,708,0,467,649,0,103,43,176,239,846
2024-10-23,18éûîº,761,246,515,0,293,321,0,103,43,176,138,445,246,515,0,293,321,0,103,43,176,138,445
2024-10-23,19éû,846,246,600,0,293,414,25,69,43,235,138,471,246,600,0,293,414,25,69,43,235,138,471
2024-10-23,19éûîº,896,240,656,0,236,524,59,33,43,390,138,367,240,656,0,236,524,59,33,43,390,138,367
2024-10-23,20éû,689,243,446,0,236,321,69,63,0,265,138,286,243,446,0,236,321,69,63,0,265,138,286
2024-10-23,20éûîº,565,259,306,0,93,344,65,63,0,29,138,397,259,306,0,93,344,65,63,0,29,138,397
2024-10-23,21éû,538,286,252,0,93,323,92,29,0,29,51,457,286,252,0,93,323,92,29,0,29,51,457
2024-10-23,21éûîº,303,141,162,0,0,181,92,29,0,29,0,274,141,162,0,0,181,92,29,0,29,0,274
2024-10-23,22éû,160,65,95,0,0,65,65,29,0,29,0,131,65,95,0,0,65,65,29,0,29,0,131
2024-10-23,22éûîº,131,66,65,0,0,103,0,29,0,29,0,103,66,65,0,0,103,0,29,0,29,0,103
2024-10-23,23éû,131,66,65,0,0,103,0,29,0,29,0,103,66,65,0,0,103,0,29,0,29,0,103
2024-10-23,23éûîº,131,66,65,0,0,103,0,29,0,29,0,103,66,65,0,0,103,0,29,0,29,0,103
2024-10-23,24éû,165,66,99,0,0,103,0,63,0,63,0,103,66,99,0,0,103,0,63,0,63,0,103
2024-10-23,24éûîº,165,66,99,0,0,103,0,63,0,63,0,103,66,99,0,0,103,0,63,0,63,0,103
2024-10-23,25éû,165,66,99,0,0,103,0,63,0,63,0,103,66,99,0,0,103,0,63,0,63,0,103
2024-10-23,25éûîº,165,66,99,0,0,103,0,63,0,63,0,103,66,99,0,0,103,0,63,0,63,0,103
2024-10-23,26éû,165,66,99,0,0,103,0,63,0,63,0,103,66,99,0,0,103,0,63,0,63,0,103
2024-10-23,26éûîº,165,66,99,0,0,103,0,63,0,63,0,103,66,99,0,0,103,0,63,0,63,0,103
2024-10-23,27éû,165,66,99,0,0,103,0,63,0,63,0,103,66,99,0,0,103,0,63,0,63,0,103
2024-10-23,27éûîº,198,66,132,0,0,103,0,96,0,96,0,103,66,132,0,0,103,0,96,0,96,0,103
2024-10-23,28éû,198,66,132,0,0,103,0,96,0,96,0,103,66,132,0,0,103,0,96,0,96,0,103
2024-10-23,28éûîº,198,66,132,0,0,103,0,96,0,96,0,103,66,132,0,0,103,0,96,0,96,0,103
2024-10-24,5éû,65,0,65,0,0,65,0,0,0,0,0,65,0,65,0,0,65,0,0,0,0,0,65
2024-10-24,5éûîº,65,0,65,0,0,65,0,0,0,0,0,65,0,65,0,0,65,0,0,0,0,0,65
2024-10-24,6éû,65,0,65,0,0,65,0,0,0,0,0,65,0,65,0,0,65,0,0,0,0,0,65
2024-10-24,6éûîº,65,0,65,0,0,65,0,0,0,0,0,65,0,65,0,0,65,0,0,0,0,0,65
2024-10-24,7éû,119,22,97,0,0,65,31,0,22,0,0,119,22,97,0,0,65,31,0,22,0,0,119
2024-10-24,7éûîº,138,30,108,0,0,65,73,0,0,0,0,139,30,108,0,0,65,73,0,0,0,0,139
2024-10-24,8éû,157,92,65,0,61,65,30,0,0,0,61,96,92,65,0,61,65,30,0,0,0,61,96
2024-10-24,8éûîº,119,54,65,0,0,120,0,0,0,0,0,120,54,65,0,0,120,0,0,0,0,0,120
2024-10-24,9éû,266,50,216,0,182,50,34,0,0,0,0,267,50,216,0,182,50,34,0,0,0,0,267
2024-10-24,9éûîº,599,203,396,0,251,285,63,0,0,0,155,444,203,396,0,251,285,63,0,0,0,155,444
2024-10-24,10éû,801,314,487,0,251,377,93,33,46,0,155,646,314,487,0,251,377,93,33,46,0,155,646
2024-10-24,10éûîº,829,336,493,120,251,372,0,0,85,39,155,635,336,493,120,251,372,0,0,85,39,155,635
2024-10-24,11éû,864,310,554,120,251,322,23,60,85,39,155,669,310,554,120,251,322,23,60,85,39,155,669
2024-10-24,11éûîº,1111,302,809,120,394,384,79,60,71,61,298,751,302,809,120,394,384,79,60,71,61,298,751
2024-10-24,12éû,1328,554,774,120,251,531,224,56,143,91,155,1081,554,774,120,251,531,224,56,143,91,155,1081
2024-10-24,12éûîº,1311,564,747,120,251,480,285,29,143,91,155,1064,564,747,120,251,480,285,29,143,91,155,1064
2024-10-24,13éû,1262,520,742,120,251,384,291,31,183,61,155,1045,520,742,120,251,384,291,31,183,61,155,1045
2024-10-24,13éûîº,1460,648,812,120,412,457,221,66,183,61,155,1244,648,812,120,412,457,221,66,183,61,155,1244
2024-10-24,14éû,990,413,577,120,412,313,0,31,111,61,155,773,413,577,120,412,313,0,31,111,61,155,773
2024-10-24,14éûîº,1515,830,685,378,495,448,68,56,68,198,155,1161,830,685,378,495,448,68,56,68,198,155,1161
2024-10-24,15éû,1122,777,345,378,495,148,68,31,0,198,155,769,777,345,378,495,148,68,31,0,198,155,769
2024-10-24,15éûîº,1104,835,269,378,412,193,120,0,0,198,155,750,835,269,378,412,193,120,0,0,198,155,750
2024-10-24,16éû,1305,988,317,400,412,305,96,0,90,61,155,1089,988,317,400,412,305,96,0,90,61,155,1089
2024-10-24,16éûîº,1384,871,513,400,412,261,68,0,242,101,210,1073,871,513,400,412,261,68,0,242,101,210,1073
2024-10-24,17éû,1401,758,643,400,339,304,114,0,242,193,210,998,758,643,400,339,304,114,0,242,193,210,998
2024-10-24,17éûîº,1217,494,723,159,339,542,82,0,95,154,155,908,494,723,159,339,542,82,0,95,154,155,908
2024-10-24,18éû,1462,732,730,286,422,633,44,29,46,154,155,1153,732,730,286,422,633,44,29,46,154,155,1153
2024-10-24,18éûîº,1248,703,545,286,422,448,44,0,46,61,155,1031,703,545,286,422,448,44,0,46,61,155,1031
2024-10-24,19éû,996,588,408,286,422,241,0,0,46,61,155,780,588,408,286,422,241,0,0,46,61,155,780
2024-10-24,19éûîº,970,654,316,286,422,148,66,0,46,95,188,720,654,316,286,422,148,66,0,46,95,188,720
2024-10-24,20éû,765,621,144,286,297,148,33,0,0,95,188,515,621,144,286,297,148,33,0,0,95,188,515
2024-10-24,20éûîº,638,494,144,159,297,148,33,0,0,95,188,387,494,144,159,297,148,33,0,0,95,188,387
2024-10-24,21éû,527,470,57,159,214,61,33,59,0,95,101,364,470,57,159,214,61,33,59,0,95,101,364
2024-10-24,21éûîº,558,501,57,159,214,61,64,59,0,95,101,395,501,57,159,214,61,64,59,0,95,101,395
2024-10-24,22éû,698,641,57,295,214,61,97,29,0,231,101,398,641,57,295,214,61,97,29,0,231,101,398
2024-10-24,22éûîº,499,442,57,159,214,61,64,0,0,95,101,335,442,57,159,214,61,64,0,0,95,101,335
2024-10-24,23éû,220,163,57,0,125,61,33,0,0,95,101,57,163,57,0,125,61,33,0,0,95,101,57
2024-10-24,23éûîº,163,163,0,0,68,61,33,0,0,95,33,68,163,0,0,68,61,33,0,0,95,33,68
2024-10-24,24éû,163,163,0,0,68,61,33,0,0,95,33,68,163,0,0,68,61,33,0,0,95,33,68
2024-10-24,24éûîº,33,33,0,0,0,0,33,0,0,33,33,0,33,0,0,0,0,33,0,0,33,33,0
2024-10-24,25éû,33,33,0,0,0,0,33,0,0,33,33,0,33,0,0,0,0,33,0,0,33,33,0
2024-10-24,25éûîº,33,33,0,0,0,0,33,0,0,33,33,0,33,0,0,0,0,33,0,0,33,33,0
2024-10-24,26éû,33,33,0,0,0,0,33,0,0,33,33,0,33,0,0,0,0,33,0,0,33,33,0
2024-10-24,26éûîº,33,33,0,0,0,0,33,0,0,33,33,0,33,0,0,0,0,33,0,0,33,33,0
2024-10-24,27éû,33,33,0,0,0,0,33,0,0,33,33,0,33,0,0,0,0,33,0,0,33,33,0
2024-10-24,27éûîº,33,33,0,0,0,0,33,0,0,33,33,0,33,0,0,0,0,33,0,0,33,33,0
2024-10-24,28éû,176,33,143,0,143,0,33,0,0,176,33,0,33,143,0,143,0,33,0,0,176,33,0
2024-10-24,28éûîº,176,33,143,0,143,0,33,0,0,176,33,0,33,143,0,143,0,33,0,0,176,33,0
2024-10-25,5éû,273,130,143,0,236,37,0,0,0,143,0,130,130,143,0,236,37,0,0,0,143,0,130
2024-10-25,5éûîº,180,37,143,0,143,37,0,0,0,143,0,37,37,143,0,143,37,0,0,0,143,0,37
2024-10-25,6éû,212,69,143,0,143,37,32,0,0,143,0,69,69,143,0,143,37,32,0,0,143,0,69
2024-10-25,6éûîº,180,37,143,0,143,37,0,0,0,143,0,37,37,143,0,143,37,0,0,0,143,0,37
2024-10-25,7éû,143,0,143,0,143,0,0,0,0,143,0,0,0,143,0,143,0,0,0,0,143,0,0
2024-10-25,7éûîº,143,0,143,0,143,0,0,0,0,143,0,0,0,143,0,143,0,0,0,0,143,0,0
2024-10-25,8éû,318,175,143,0,205,113,0,0,0,205,61,51,175,143,0,205,113,0,0,0,205,61,51
2024-10-25,8éûîº,412,168,244,168,244,0,0,0,0,143,101,168,168,244,168,244,0,0,0,0,143,101,168
2024-10-25,9éû,610,223,387,168,387,0,55,0,0,143,101,367,223,387,168,387,0,55,0,0,143,101,367
2024-10-25,9éûîº,872,261,611,168,456,184,62,0,0,235,169,467,261,611,168,456,184,62,0,0,235,169,467
2024-10-25,10éû,795,287,508,168,244,246,95,0,40,235,101,459,287,508,168,244,246,95,0,40,235,101,459
2024-10-25,10éûîº,913,342,571,168,244,308,151,0,40,143,156,613,342,571,168,244,308,151,0,40,143,156,613
2024-10-25,11éû,1107,421,686,168,297,308,255,0,77,143,156,807,421,686,168,297,308,255,0,77,143,156,807
2024-10-25,11éûîº,1130,345,785,168,387,246,162,41,124,61,244,824,345,785,168,387,246,162,41,124,61,244,824
2024-10-25,12éû,1176,377,799,168,275,360,146,101,124,95,101,980,377,799,168,275,360,146,101,124,95,101,980
2024-10-25,12éûîº,1467,396,1071,265,365,471,146,131,87,157,396,914,396,1071,265,365,471,146,131,87,157,396,914
2024-10-25,13éû,1033,228,805,265,191,364,136,30,46,61,396,576,228,805,265,191,364,136,30,46,61,396,576
2024-10-25,13éûîº,1386,575,811,424,349,323,114,91,82,61,486,837,575,811,424,349,323,114,91,82,61,486,837
2024-10-25,14éû,959,541,418,159,411,223,78,52,35,61,253,645,541,418,159,411,223,78,52,35,61,253,645
2024-10-25,14éûîº,968,452,516,159,349,315,24,84,35,61,191,715,452,516,159,349,315,24,84,35,61,191,715
2024-10-25,15éû,1131,576,555,159,334,464,24,114,35,61,191,879,576,555,159,334,464,24,114,35,61,191,879
2024-10-25,15éûîº,1188,696,492,159,402,275,130,220,0,61,259,867,696,492,159,402,275,130,220,0,61,259,867
2024-10-25,16éû,1411,886,525,332,478,325,86,187,0,95,259,1056,886,525,332,478,325,86,187,0,95,259,1056
2024-10-25,16éûîº,1288,729,559,332,493,218,89,154,0,61,259,966,729,559,332,493,218,89,154,0,61,259,966
2024-10-25,17éû,1097,606,491,277,403,128,100,188,0,61,259,776,606,491,277,403,128,100,188,0,61,259,776
2024-10-25,17éûîº,704,423,281,159,259,61,87,103,33,95,259,349,423,281,159,259,61,87,103,33,95,259,349
2024-10-25,18éû,700,383,317,159,158,154,131,63,33,217,158,324,383,317,159,158,154,131,63,33,217,158,324
2024-10-25,18éûîº,667,257,410,159,158,184,131,33,0,125,158,383,257,410,159,158,184,131,33,0,125,158,383
2024-10-25,19éû,1143,421,722,415,262,154,278,33,0,95,158,890,421,722,415,262,154,278,33,0,95,158,890
2024-10-25,19éûîº,1029,352,677,415,262,92,196,63,0,33,158,838,352,677,415,262,92,196,63,0,33,158,838
2024-10-25,20éû,876,353,523,415,262,0,198,0,0,0,158,717,353,523,415,262,0,198,0,0,0,158,717
2024-10-25,20éûîº,624,160,464,256,158,0,165,0,45,0,158,466,160,464,256,158,0,165,0,45,0,158,466
2024-10-25,21éû,747,357,390,392,251,0,103,0,0,136,158,452,357,390,392,251,0,103,0,0,136,158,452
2024-10-25,21éûîº,697,351,346,392,251,0,26,27,0,136,158,402,351,346,392,251,0,26,27,0,136,158,402
2024-10-25,22éû,215,215,0,0,161,0,26,27,0,0,68,146,215,0,0,161,0,26,27,0,0,68,146
2024-10-25,22éûîº,215,215,0,0,161,0,26,27,0,0,68,146,215,0,0,161,0,26,27,0,0,68,146
2024-10-25,23éû,187,187,0,0,161,0,26,0,0,0,68,119,187,0,0,161,0,26,0,0,0,68,119
2024-10-25,23éûîº,119,119,0,0,93,0,26,0,0,0,0,119,119,0,0,93,0,26,0,0,0,0,119
2024-10-25,24éû,119,119,0,0,93,0,26,0,0,0,0,119,119,0,0,93,0,26,0,0,0,0,119
2024-10-25,24éûîº,119,119,0,0,93,0,26,0,0,0,0,119,119,0,0,93,0,26,0,0,0,0,119
2024-10-25,25éû,181,181,0,0,93,61,26,0,0,0,0,181,181,0,0,93,61,26,0,0,0,0,181
2024-10-25,25éûîº,181,181,0,0,93,61,26,0,0,0,0,181,181,0,0,93,61,26,0,0,0,0,181
2024-10-25,26éû,181,181,0,0,93,61,26,0,0,0,0,181,181,0,0,93,61,26,0,0,0,0,181
2024-10-25,26éûîº,181,181,0,0,93,61,26,0,0,0,0,181,181,0,0,93,61,26,0,0,0,0,181
2024-10-25,27éû,181,181,0,0,93,61,26,0,0,0,0,181,181,0,0,93,61,26,0,0,0,0,181
2024-10-25,27éûîº,181,181,0,0,93,61,26,0,0,0,0,181,181,0,0,93,61,26,0,0,0,0,181
2024-10-25,28éû,181,181,0,0,93,61,26,0,0,0,0,181,181,0,0,93,61,26,0,0,0,0,181
2024-10-25,28éûîº,268,268,0,0,152,61,53,0,0,0,0,268,268,0,0,152,61,53,0,0,0,0,268
2024-10-26,5éû,93,93,0,0,93,0,0,0,0,0,0,93,93,0,0,93,0,0,0,0,0,0,93
2024-10-26,5éûîº,93,93,0,0,93,0,0,0,0,0,0,93,93,0,0,93,0,0,0,0,0,0,93
2024-10-26,6éû,93,93,0,0,93,0,0,0,0,0,0,93,93,0,0,93,0,0,0,0,0,0,93
2024-10-26,6éûîº,150,150,0,0,93,57,0,0,0,0,0,150,150,0,0,93,57,0,0,0,0,0,150
2024-10-26,7éû,93,93,0,0,93,0,0,0,0,0,0,93,93,0,0,93,0,0,0,0,0,0,93
2024-10-26,7éûîº,404,163,241,241,93,0,33,37,0,0,0,404,163,241,241,93,0,33,37,0,0,0,404
2024-10-26,8éû,331,90,241,241,53,0,0,37,0,0,0,331,90,241,241,53,0,0,37,0,0,0,331
2024-10-26,8éûîº,504,173,331,241,143,56,26,37,0,0,90,414,173,331,241,143,56,26,37,0,0,90,414
2024-10-26,9éû,508,37,471,241,143,86,0,37,0,0,176,332,37,471,241,143,86,0,37,0,0,176,332
2024-10-26,9éûîº,817,77,740,241,227,312,0,37,0,92,176,548,77,740,241,227,312,0,37,0,92,176,548
2024-10-26,10éû,871,215,656,355,207,271,0,37,0,92,176,602,215,656,355,207,271,0,37,0,92,176,602
2024-10-26,10éûîº,1277,531,746,474,411,285,32,74,0,0,228,1049,531,746,474,411,285,32,74,0,0,228,1049
2024-10-26,11éû,1603,582,1021,474,404,442,126,154,0,154,228,1220,582,1021,474,404,442,126,154,0,154,228,1220
2024-10-26,11éûîº,2209,799,1410,662,709,347,269,220,0,154,372,1684,799,1410,662,709,347,269,220,0,154,372,1684
2024-10-26,12éû,2860,1254,1606,930,801,473,269,338,46,246,228,2385,1254,1606,930,801,473,269,338,46,246,228,2385
2024-10-26,12éûîº,3684,1219,2465,1544,850,594,283,365,46,184,176,3324,1219,2465,1544,850,594,283,365,46,184,176,3324
2024-10-26,13éû,5178,1854,3324,2296,1090,778,364,561,86,247,278,4653,1854,3324,2296,1090,778,364,561,86,247,278,4653
2024-10-26,13éûîº,5992,2399,3593,1927,1825,1031,395,608,205,247,278,5467,2399,3593,1927,1825,1031,395,608,205,247,278,5467
2024-10-26,14éû,5342,2554,2788,1681,1743,725,351,635,205,217,278,4846,2554,2788,1681,1743,725,351,635,205,217,278,4846
2024-10-26,14éûîº,6057,2898,3159,1752,2425,933,316,491,139,125,384,5548,2898,3159,1752,2425,933,316,491,139,125,384,5548
2024-10-26,15éû,5768,2784,2984,1440,2573,801,285,445,222,125,384,5259,2784,2984,1440,2573,801,285,445,222,125,384,5259
2024-10-26,15éûîº,5455,2644,2811,1317,2357,746,305,451,277,125,329,5000,2644,2811,1317,2357,746,305,451,277,125,329,5000
2024-10-26,16éû,5554,2801,2753,1378,1951,929,464,519,311,125,329,5099,2801,2753,1378,1951,929,464,519,311,125,329,5099
2024-10-26,16éûîº,6128,2877,3251,1546,2337,1013,427,518,284,125,384,5618,2877,3251,1546,2337,1013,427,518,284,125,384,5618
2024-10-26,17éû,5390,2106,3284,1232,2102,811,500,548,195,125,329,4936,2106,3284,1232,2102,811,500,548,195,125,329,4936
2024-10-26,17éûîº,4502,1272,3230,1170,1351,783,469,585,141,125,329,4047,1272,3230,1170,1351,783,469,585,141,125,329,4047
2024-10-26,18éû,3544,1359,2185,611,1072,755,467,508,128,169,228,3146,1359,2185,611,1072,755,467,508,128,169,228,3146
2024-10-26,18éûîº,2609,1131,1478,391,859,481,369,378,128,139,86,2382,1131,1478,391,859,481,369,378,128,139,86,2382
2024-10-26,19éû,2160,950,1210,270,765,351,341,303,128,139,86,1934,950,1210,270,765,351,341,303,128,139,86,1934
2024-10-26,19éûîº,2264,1160,1104,257,780,429,370,297,128,222,86,1955,1160,1104,257,780,429,370,297,128,222,86,1955
2024-10-26,20éû,2449,1207,1242,543,697,453,278,348,128,358,86,2004,1207,1242,543,697,453,278,348,128,358,86,2004
2024-10-26,20éûîº,2384,1218,1166,406,651,582,316,272,155,314,86,1983,1218,1166,406,651,582,316,272,155,314,86,1983
2024-10-26,21éû,2913,1568,1345,1071,602,586,354,229,68,95,0,2818,1568,1345,1071,602,586,354,229,68,95,0,2818
2024-10-26,21éûîº,2211,1213,998,966,467,485,231,60,0,61,0,2150,1213,998,966,467,485,231,60,0,61,0,2150
2024-10-26,22éû,1633,693,940,769,351,338,147,27,0,61,0,1572,693,940,769,351,338,147,27,0,61,0,1572
2024-10-26,22éûîº,1309,481,828,690,263,209,145,0,0,61,0,1247,481,828,690,263,209,145,0,0,61,0,1247
2024-10-26,23éû,586,150,436,256,164,166,0,0,0,61,0,525,150,436,256,164,166,0,0,0,61,0,525
2024-10-26,23éûîº,317,61,256,256,0,61,0,0,0,61,0,256,61,256,256,0,61,0,0,0,61,0,256
2024-10-26,24éû,256,0,256,256,0,0,0,0,0,0,0,256,0,256,256,0,0,0,0,0,0,0,256
2024-10-26,24éûîº,0,0,0,0,0,0,0,0,0,0,0,0,0,0,0,0,0,0,0,0,0,0,0
2024-10-26,25éû,0,0,0,0,0,0,0,0,0,0,0,0,0,0,0,0,0,0,0,0,0,0,0
2024-10-26,25éûîº,0,0,0,0,0,0,0,0,0,0,0,0,0,0,0,0,0,0,0,0,0,0,0
2024-10-26,26éû,0,0,0,0,0,0,0,0,0,0,0,0,0,0,0,0,0,0,0,0,0,0,0
2024-10-26,26éûîº,0,0,0,0,0,0,0,0,0,0,0,0,0,0,0,0,0,0,0,0,0,0,0
2024-10-26,27éû,0,0,0,0,0,0,0,0,0,0,0,0,0,0,0,0,0,0,0,0,0,0,0
2024-10-26,27éûîº,0,0,0,0,0,0,0,0,0,0,0,0,0,0,0,0,0,0,0,0,0,0,0
2024-10-26,28éû,33,33,0,0,0,0,33,0,0,0,0,33,33,0,0,0,0,33,0,0,0,0,33
2024-10-26,28éûîº,0,0,0,0,0,0,0,0,0,0,0,0,0,0,0,0,0,0,0,0,0,0,0
2024-10-27,5éû,91,91,0,0,0,61,0,29,0,29,0,61,91,0,0,0,61,0,29,0,29,0,61
2024-10-27,5éûîº,29,29,0,0,0,0,0,29,0,29,0,0,29,0,0,0,0,0,29,0,29,0,0
2024-10-27,6éû,107,29,78,0,78,0,0,29,0,29,0,78,29,78,0,78,0,0,29,0,29,0,78
2024-10-27,6éûîº,116,29,87,0,87,0,0,29,0,29,0,87,29,87,0,87,0,0,29,0,29,0,87
2024-10-27,7éû,29,29,0,0,0,0,0,29,0,29,0,0,29,0,0,0,0,0,29,0,29,0,0
2024-10-27,7éûîº,117,117,0,0,87,0,0,29,0,29,0,87,117,0,0,87,0,0,29,0,29,0,87
2024-10-27,8éû,374,118,256,256,0,51,0,66,0,29,51,293,118,256,256,0,51,0,66,0,29,51,293
2024-10-27,8éûîº,276,206,70,121,0,121,33,0,0,0,51,224,206,70,121,0,121,33,0,0,0,51,224
2024-10-27,9éû,365,328,37,121,68,107,37,30,0,0,158,207,328,37,121,68,107,37,30,0,0,158,207
2024-10-27,9éûîº,441,404,37,121,68,150,70,30,0,0,158,284,404,37,121,68,150,70,30,0,0,158,284
2024-10-27,10éû,706,516,190,159,103,244,136,63,0,61,279,365,516,190,159,103,244,136,63,0,61,279,365
2024-10-27,10éûîº,1870,831,1039,568,569,421,206,63,39,184,279,1406,831,1039,568,569,421,206,63,39,184,279,1406
2024-10-27,11éû,3069,1039,2030,829,774,921,409,95,39,224,369,2476,1039,2030,829,774,921,409,95,39,224,369,2476
2024-10-27,11éûîº,3697,1267,2430,946,1029,941,488,292,0,218,317,3161,1267,2430,946,1029,941,488,292,0,218,317,3161
2024-10-27,12éû,4763,1610,3153,1322,1341,1033,587,375,102,125,249,4390,1610,3153,1322,1341,1033,587,375,102,125,249,4390
2024-10-27,12éûîº,4720,1771,2949,1249,1182,1277,490,447,73,29,249,4442,1771,2949,1249,1182,1277,490,447,73,29,249,4442
2024-10-27,13éû,4259,1684,2575,993,1274,1131,423,363,73,29,317,3912,1684,2575,993,1274,1131,423,363,73,29,317,3912
2024-10-27,13éûîº,4316,1466,2850,1249,1066,1260,434,279,26,29,317,3969,1466,2850,1249,1066,1260,434,279,26,29,317,3969
2024-10-27,14éû,4367,1699,2668,1011,1178,1230,503,417,26,92,317,3957,1699,2668,1011,1178,1230,503,417,26,92,317,3957
2024-10-27,14éûîº,4689,1603,3086,902,1402,1562,408,387,26,207,280,4202,1603,3086,902,1402,1562,408,387,26,207,280,4202
2024-10-27,15éû,4993,1735,3258,1201,1464,1509,404,387,26,207,280,4506,1735,3258,1201,1464,1509,404,387,26,207,280,4506
2024-10-27,15éûîº,4778,1481,3297,1365,1266,1516,346,228,55,174,211,4392,1481,3297,1365,1266,1516,346,228,55,174,211,4392
2024-10-27,16éû,5559,1914,3645,1491,1598,1571,502,217,177,174,211,5173,1914,3645,1491,1598,1571,502,217,177,174,211,5173
2024-10-27,16éûîº,4426,1723,2703,902,1432,1328,372,260,131,300,280,3846,1723,2703,902,1432,1328,372,260,131,300,280,3846
2024-10-27,17éû,2991,1181,1810,536,996,1002,184,243,28,207,263,2520,1181,1810,536,996,1002,184,243,28,207,263,2520
2024-10-27,17éûîº,2551,1031,1520,536,719,849,103,239,102,213,263,2074,1031,1520,536,719,849,103,239,102,213,263,2074
2024-10-27,18éû,1982,968,1014,694,418,582,40,179,66,184,211,1586,968,1014,694,418,582,40,179,66,184,211,1586
2024-10-27,18éûîº,1708,639,1069,573,467,461,40,99,66,327,176,1204,639,1069,573,467,461,40,99,66,327,176,1204
2024-10-27,19éû,1514,485,1029,415,467,461,41,89,39,327,176,1010,485,1029,415,467,461,41,89,39,327,176,1010
2024-10-27,19éûîº,1175,449,726,415,309,349,41,59,0,235,176,764,449,726,415,309,349,41,59,0,235,176,764
2024-10-27,20éû,1520,482,1038,415,453,484,74,93,0,378,176,966,482,1038,415,453,484,74,93,0,378,176,966
2024-10-27,20éûîº,1056,261,795,256,309,356,74,59,0,173,176,707,261,795,256,309,356,74,59,0,173,176,707
2024-10-27,21éû,924,351,573,256,309,191,108,59,0,206,90,628,351,573,256,309,191,108,59,0,206,90,628
2024-10-27,21éûîº,811,328,483,256,219,135,141,59,0,206,0,605,328,483,256,219,135,141,59,0,206,0,605
2024-10-27,22éû,489,149,340,256,0,135,68,29,0,29,0,459,149,340,256,0,135,68,29,0,29,0,459
2024-10-27,22éûîº,274,190,84,0,68,135,41,29,0,29,0,245,190,84,0,68,135,41,29,0,29,0,245
2024-10-27,23éû,222,190,32,0,68,50,41,62,0,29,0,193,190,32,0,68,50,41,62,0,29,0,193
2024-10-27,23éûîº,332,122,210,0,178,50,41,62,0,29,0,303,122,210,0,178,50,41,62,0,29,0,303
2024-10-27,24éû,239,29,210,0,178,0,0,62,0,29,0,210,29,210,0,178,0,0,62,0,29,0,210
2024-10-27,24éûîº,239,29,210,0,178,0,0,62,0,29,0,210,29,210,0,178,0,0,62,0,29,0,210
2024-10-27,25éû,29,29,0,0,0,0,0,29,0,29,0,0,29,0,0,0,0,0,29,0,29,0,0
2024-10-27,25éûîº,29,29,0,0,0,0,0,29,0,29,0,0,29,0,0,0,0,0,29,0,29,0,0
2024-10-27,26éû,29,29,0,0,0,0,0,29,0,29,0,0,29,0,0,0,0,0,29,0,29,0,0
2024-10-27,26éûîº,29,29,0,0,0,0,0,29,0,29,0,0,29,0,0,0,0,0,29,0,29,0,0
2024-10-27,27éû,29,29,0,0,0,0,0,29,0,29,0,0,29,0,0,0,0,0,29,0,29,0,0
2024-10-27,27éûîº,29,29,0,0,0,0,0,29,0,29,0,0,29,0,0,0,0,0,29,0,29,0,0
2024-10-27,28éû,62,62,0,0,0,0,33,29,0,29,0,33,62,0,0,0,0,33,29,0,29,0,33
2024-10-27,28éûîº,29,29,0,0,0,0,0,29,0,29,0,0,29,0,0,0,0,0,29,0,29,0,0
2024-10-28,5éû,0,0,0,0,0,0,0,0,0,0,0,0,0,0,0,0,0,0,0,0,0,0,0
2024-10-28,5éûîº,0,0,0,0,0,0,0,0,0,0,0,0,0,0,0,0,0,0,0,0,0,0,0
2024-10-28,6éû,0,0,0,0,0,0,0,0,0,0,0,0,0,0,0,0,0,0,0,0,0,0,0
2024-10-28,6éûîº,74,74,0,0,0,51,22,0,0,0,51,22,74,0,0,0,51,22,0,0,0,51,22
2024-10-28,7éû,51,51,0,0,0,51,0,0,0,0,51,0,51,0,0,0,51,0,0,0,0,51,0
2024-10-28,7éûîº,0,0,0,0,0,0,0,0,0,0,0,0,0,0,0,0,0,0,0,0,0,0,0
2024-10-28,8éû,134,134,0,0,82,51,0,0,0,0,51,82,134,0,0,82,51,0,0,0,0,51,82
2024-10-28,8éûîº,157,113,44,0,0,113,44,0,0,44,113,0,113,44,0,0,113,44,0,0,44,113,0
2024-10-28,9éû,195,113,82,0,0,113,82,0,0,44,151,0,113,82,0,0,113,82,0,0,44,151,0
2024-10-28,9éûîº,366,98,268,0,0,251,82,33,0,44,176,145,98,268,0,0,251,82,33,0,44,176,145
2024-10-28,10éû,483,98,385,0,84,246,112,0,39,0,176,307,98,385,0,84,246,112,0,39,0,176,307
2024-10-28,10éûîº,517,30,487,0,84,148,180,25,79,0,124,393,30,487,0,84,148,180,25,79,0,124,393
2024-10-28,11éû,648,129,519,0,200,138,107,25,176,0,176,472,129,519,0,200,138,107,25,176,0,176,472
2024-10-28,11éûîº,620,302,318,0,51,200,166,25,176,0,176,444,302,318,0,51,200,166,25,176,0,176,444
2024-10-28,12éû,735,338,397,0,143,200,166,87,136,0,379,355,338,397,0,143,200,166,87,136,0,379,355
2024-10-28,12éûîº,800,362,438,0,143,250,183,87,136,0,379,421,362,438,0,143,250,183,87,136,0,379,421
2024-10-28,13éû,530,327,203,0,0,250,222,57,0,0,206,324,327,203,0,0,250,222,57,0,0,206,324
2024-10-28,13éûîº,894,398,496,190,93,272,277,60,0,0,176,718,398,496,190,93,272,277,60,0,0,176,718
2024-10-28,14éû,884,385,499,0,276,379,152,76,0,61,138,684,385,499,0,276,379,152,76,0,61,138,684
2024-10-28,14éûîº,699,271,428,0,276,334,44,43,0,61,138,498,271,428,0,276,334,44,43,0,61,138,498
2024-10-28,15éû,697,299,398,0,276,270,44,106,0,61,126,509,299,398,0,276,270,44,106,0,61,126,509
2024-10-28,15éûîº,1014,283,731,190,366,270,110,43,33,61,86,865,283,731,190,366,270,110,43,33,61,86,865
2024-10-28,16éû,850,314,536,0,366,270,97,43,73,61,86,701,314,536,0,366,270,97,43,73,61,86,701
2024-10-28,16éûîº,608,244,364,0,183,264,33,0,128,61,193,354,244,364,0,183,264,33,0,128,61,193,354
2024-10-28,17éû,472,386,86,0,0,379,66,27,0,95,138,239,386,86,0,0,379,66,27,0,95,138,239
2024-10-28,17éûîº,696,316,380,0,246,212,142,60,33,128,86,481,316,380,0,246,212,142,60,33,128,86,481
2024-10-28,18éû,479,291,188,0,62,212,144,25,33,95,86,297,291,188,0,62,212,144,25,33,95,86,297
2024-10-28,18éûîº,498,262,236,0,0,356,90,52,0,187,86,224,262,236,0,0,356,90,52,0,187,86,224
2024-10-28,19éû,658,371,287,136,143,263,90,25,0,375,86,197,371,287,136,143,263,90,25,0,375,86,197
2024-10-28,19éûîº,872,493,379,272,143,341,90,25,0,467,86,318,493,379,272,143,341,90,25,0,467,86,318
2024-10-28,20éû,872,524,348,272,143,341,89,25,0,467,86,317,524,348,272,143,341,89,25,0,467,86,317
2024-10-28,20éûîº,674,444,230,272,143,199,58,0,0,375,86,212,444,230,272,143,199,58,0,0,375,86,212
2024-10-28,21éû,399,307,92,136,0,205,58,0,0,324,0,76,307,92,136,0,205,58,0,0,324,0,76
2024-10-28,21éûîº,565,473,92,136,136,205,58,29,0,436,0,129,473,92,136,136,205,58,29,0,436,0,129
2024-10-28,22éû,397,397,0,136,136,61,33,29,0,344,0,53,397,0,136,136,61,33,29,0,344,0,53
2024-10-28,22éûîº,583,583,0,322,136,61,33,29,0,480,0,103,583,0,322,136,61,33,29,0,480,0,103
2024-10-28,23éû,344,344,0,136,82,61,33,29,0,344,0,0,344,0,136,82,61,33,29,0,344,0,0
2024-10-28,23éûîº,344,344,0,136,82,61,33,29,0,344,0,0,344,0,136,82,61,33,29,0,344,0,0
2024-10-28,24éû,166,166,0,136,0,0,0,29,0,166,0,0,166,0,136,0,0,0,29,0,166,0,0
2024-10-28,24éûîº,166,166,0,136,0,0,0,29,0,166,0,0,166,0,136,0,0,0,29,0,166,0,0
2024-10-28,25éû,166,166,0,136,0,0,0,29,0,166,0,0,166,0,136,0,0,0,29,0,166,0,0
2024-10-28,25éûîº,166,166,0,136,0,0,0,29,0,166,0,0,166,0,136,0,0,0,29,0,166,0,0
2024-10-28,26éû,166,166,0,136,0,0,0,29,0,166,0,0,166,0,136,0,0,0,29,0,166,0,0
2024-10-28,26éûîº,166,166,0,136,0,0,0,29,0,166,0,0,166,0,136,0,0,0,29,0,166,0,0
2024-10-28,27éû,166,166,0,136,0,0,0,29,0,166,0,0,166,0,136,0,0,0,29,0,166,0,0
2024-10-28,27éûîº,166,166,0,136,0,0,0,29,0,166,0,0,166,0,136,0,0,0,29,0,166,0,0
2024-10-28,28éû,166,166,0,136,0,0,0,29,0,166,0,0,166,0,136,0,0,0,29,0,166,0,0
2024-10-28,28éûîº,166,166,0,136,0,0,0,29,0,166,0,0,166,0,136,0,0,0,29,0,166,0,0
2024-10-29,5éû,0,0,0,0,0,0,0,0,0,0,0,0,0,0,0,0,0,0,0,0,0,0,0
2024-10-29,5éûîº,0,0,0,0,0,0,0,0,0,0,0,0,0,0,0,0,0,0,0,0,0,0,0
2024-10-29,6éû,31,31,0,0,0,0,31,0,0,0,0,31,31,0,0,0,0,31,0,0,0,0,31
2024-10-29,6éûîº,0,0,0,0,0,0,0,0,0,0,0,0,0,0,0,0,0,0,0,0,0,0,0
2024-10-29,7éû,0,0,0,0,0,0,0,0,0,0,0,0,0,0,0,0,0,0,0,0,0,0,0
2024-10-29,7éûîº,23,23,0,0,0,0,23,0,0,0,0,23,23,0,0,0,0,23,0,0,0,0,23
2024-10-29,8éû,124,23,101,0,101,0,23,0,0,0,101,23,23,101,0,101,0,23,0,0,0,101,23
2024-10-29,8éûîº,376,93,283,0,283,61,31,0,0,0,163,213,93,283,0,283,61,31,0,0,0,163,213
2024-10-29,9éû,703,237,466,0,408,264,31,0,0,0,287,416,237,466,0,408,264,31,0,0,0,287,416
2024-10-29,9éûîº,679,213,466,0,476,202,0,0,0,0,294,385,213,466,0,476,202,0,0,0,0,294,385
2024-10-29,10éû,760,210,550,0,476,147,96,0,39,0,294,466,210,550,0,476,147,96,0,39,0,294,466
2024-10-29,10éûîº,1141,324,817,256,476,169,155,45,39,0,294,848,324,817,256,476,169,155,45,39,0,294,848
2024-10-29,11éû,1285,342,943,256,476,391,77,45,39,0,294,991,342,943,256,476,391,77,45,39,0,294,991
2024-10-29,11éûîº,1411,329,1082,256,620,348,62,45,79,0,294,1117,329,1082,256,620,348,62,45,79,0,294,1117
2024-10-29,12éû,1408,326,1082,256,703,295,30,45,79,0,294,1114,326,1082,256,703,295,30,45,79,0,294,1114
2024-10-29,12éûîº,1762,388,1374,256,846,295,75,107,182,0,467,1295,388,1374,256,846,295,75,107,182,0,467,1295
2024-10-29,13éû,1740,331,1409,256,939,147,106,141,150,0,467,1273,331,1409,256,939,147,106,141,150,0,467,1273
2024-10-29,13éûîº,1763,242,1521,537,856,54,30,134,150,0,749,1014,242,1521,537,856,54,30,134,150,0,749,1014
2024-10-29,14éû,1756,269,1487,537,856,104,0,107,150,0,719,1037,269,1487,537,856,104,0,107,150,0,719,1037
2024-10-29,14éûîº,1153,212,941,0,856,47,24,113,111,0,437,716,212,941,0,856,47,24,113,111,0,437,716
2024-10-29,15éû,1188,319,869,0,856,155,24,113,39,0,437,752,319,869,0,856,155,24,113,39,0,437,752
2024-10-29,15éûîº,1176,295,881,240,620,155,44,37,79,39,294,842,295,881,240,620,155,44,37,79,39,294,842
2024-10-29,16éû,1286,198,1088,240,827,95,44,0,79,39,437,809,198,1088,240,827,95,44,0,79,39,437,809
2024-10-29,16éûîº,1460,468,992,399,813,99,74,0,73,61,347,1051,468,992,399,813,99,74,0,73,61,347,1051
2024-10-29,17éû,1184,496,688,159,750,99,74,27,73,61,347,774,496,688,159,750,99,74,27,73,61,347,774
2024-10-29,17éûîº,1195,591,604,159,606,161,167,27,73,106,347,741,591,604,159,606,161,167,27,73,106,347,741
2024-10-29,18éû,1063,490,573,159,614,99,167,23,0,187,211,664,490,573,159,614,99,167,23,0,187,211,664
2024-10-29,18éûîº,1099,434,665,159,614,192,133,0,0,280,211,607,434,665,159,614,192,133,0,0,280,211,607
2024-10-29,19éû,981,375,606,159,614,130,77,0,0,280,211,489,375,606,159,614,130,77,0,0,280,211,489
2024-10-29,19éûîº,904,435,469,295,537,38,33,0,0,279,211,412,435,469,295,537,38,33,0,0,279,211,412
2024-10-29,20éû,441,298,143,159,211,38,33,0,0,0,211,230,298,143,159,211,38,33,0,0,0,211,230
2024-10-29,20éûîº,567,424,143,159,280,61,66,0,0,0,273,293,424,143,159,280,61,66,0,0,0,273,293
2024-10-29,21éû,496,353,143,159,280,0,0,57,0,0,211,285,353,143,159,280,0,0,57,0,0,211,285
2024-10-29,21éûîº,630,323,307,159,211,200,0,60,0,0,211,419,323,307,159,211,200,0,60,0,0,211,419
2024-10-29,22éû,550,386,164,159,68,262,33,28,0,0,68,482,386,164,159,68,262,33,28,0,0,68,482
2024-10-29,22éûîº,284,284,0,159,0,97,0,28,0,0,0,284,284,0,159,0,97,0,28,0,0,0,284
2024-10-29,23éû,63,63,0,0,0,35,0,28,0,0,0,63,63,0,0,0,35,0,28,0,0,0,63
2024-10-29,23éûîº,63,63,0,0,0,35,0,28,0,0,0,63,63,0,0,0,35,0,28,0,0,0,63
2024-10-29,24éû,35,35,0,0,0,35,0,0,0,0,0,35,35,0,0,0,35,0,0,0,0,0,35
2024-10-29,24éûîº,35,35,0,0,0,35,0,0,0,0,0,35,35,0,0,0,35,0,0,0,0,0,35
2024-10-29,25éû,35,35,0,0,0,35,0,0,0,0,0,35,35,0,0,0,35,0,0,0,0,0,35
2024-10-29,25éûîº,35,35,0,0,0,35,0,0,0,0,0,35,35,0,0,0,35,0,0,0,0,0,35
2024-10-29,26éû,35,35,0,0,0,35,0,0,0,0,0,35,35,0,0,0,35,0,0,0,0,0,35
2024-10-29,26éûîº,35,35,0,0,0,35,0,0,0,0,0,35,35,0,0,0,35,0,0,0,0,0,35
2024-10-29,27éû,35,35,0,0,0,35,0,0,0,0,0,35,35,0,0,0,35,0,0,0,0,0,35
2024-10-29,27éûîº,35,35,0,0,0,35,0,0,0,0,0,35,35,0,0,0,35,0,0,0,0,0,35
2024-10-29,28éû,35,35,0,0,0,35,0,0,0,0,0,35,35,0,0,0,35,0,0,0,0,0,35
2024-10-29,28éûîº,35,35,0,0,0,35,0,0,0,0,0,35,35,0,0,0,35,0,0,0,0,0,35
2024-10-30,5éû,33,33,0,0,0,0,33,0,0,33,33,0,33,0,0,0,0,33,0,0,33,33,0
2024-10-30,5éûîº,33,33,0,0,0,0,33,0,0,33,33,0,33,0,0,0,0,33,0,0,33,33,0
2024-10-30,6éû,33,33,0,0,0,0,33,0,0,33,33,0,33,0,0,0,0,33,0,0,33,33,0
2024-10-30,6éûîº,63,63,0,0,0,0,63,0,0,33,33,30,63,0,0,0,0,63,0,0,33,33,30
2024-10-30,7éû,33,33,0,0,0,0,33,0,0,33,33,0,33,0,0,0,0,33,0,0,33,33,0
2024-10-30,7éûîº,82,82,0,0,0,49,33,0,0,33,33,49,82,0,0,0,49,33,0,0,33,33,49
2024-10-30,8éû,144,144,0,0,0,111,33,0,0,95,33,49,144,0,0,0,111,33,0,0,95,33,49
2024-10-30,8éûîº,147,147,0,0,0,113,33,0,0,95,85,0,147,0,0,0,113,33,0,0,95,85,0
2024-10-30,9éû,184,147,37,0,0,113,70,0,0,95,122,0,147,37,0,0,113,70,0,0,95,122,0
2024-10-30,9éûîº,321,145,176,0,0,174,107,0,39,101,89,130,145,176,0,0,174,107,0,39,101,89,130
2024-10-30,10éû,530,186,344,0,0,353,138,0,39,101,124,305,186,344,0,0,353,138,0,39,101,124,305
2024-10-30,10éûîº,910,304,606,256,82,364,135,33,39,184,124,602,304,606,256,82,364,135,33,39,184,124,602
2024-10-30,11éû,786,180,606,256,0,354,104,33,39,101,176,509,180,606,256,0,354,104,33,39,101,176,509
2024-10-30,11éûîº,1230,251,979,256,325,401,137,70,39,134,319,776,251,979,256,325,401,137,70,39,134,319,776
2024-10-30,12éû,1289,290,999,256,325,460,177,70,0,95,358,835,290,999,256,325,460,177,70,0,95,358,835
2024-10-30,12éûîº,1248,393,855,256,226,460,205,100,0,61,245,941,393,855,256,226,460,205,100,0,61,245,941
2024-10-30,13éû,1251,417,834,256,226,401,270,59,37,91,206,953,417,834,256,226,401,270,59,37,91,206,953
2024-10-30,13éûîº,1138,351,787,256,226,354,234,29,37,91,176,870,351,787,256,226,354,234,29,37,91,176,870
2024-10-30,14éû,950,256,694,256,226,261,139,29,37,91,176,683,256,694,256,226,261,139,29,37,91,176,683
2024-10-30,14éûîº,771,257,514,0,267,261,175,27,39,61,261,448,257,514,0,267,261,175,27,39,61,261,448
2024-10-30,15éû,726,212,514,0,302,209,175,0,39,61,209,455,212,514,0,302,209,175,0,39,61,209,455
2024-10-30,15éûîº,820,322,498,0,360,354,67,0,39,154,223,442,322,498,0,360,354,67,0,39,154,223,442
2024-10-30,16éû,1031,264,767,0,302,504,113,72,39,154,223,654,264,767,0,302,504,113,72,39,154,223,654
2024-10-30,16éûîº,1271,360,911,0,370,504,204,97,94,154,278,838,360,911,0,370,504,204,97,94,154,278,838
2024-10-30,17éû,979,360,619,0,370,261,204,87,54,61,278,638,360,619,0,370,261,204,87,54,61,278,638
2024-10-30,17éûîº,858,240,618,0,479,209,82,87,0,205,172,482,240,618,0,479,209,82,87,0,205,172,482
2024-10-30,18éû,858,273,585,0,479,209,115,54,0,205,172,481,273,585,0,479,209,115,54,0,205,172,481
2024-10-30,18éûîº,784,205,579,0,411,209,77,85,0,205,172,407,205,579,0,411,209,77,85,0,205,172,407
2024-10-30,19éû,752,205,547,0,411,209,77,54,0,205,172,375,205,547,0,411,209,77,54,0,205,172,375
2024-10-30,19éûîº,827,325,502,0,411,271,33,111,0,235,234,358,325,502,0,411,271,33,111,0,235,234,358
2024-10-30,20éû,719,235,484,0,267,302,66,83,0,184,172,363,235,484,0,267,302,66,83,0,184,172,363
2024-10-30,20éûîº,656,260,396,0,267,209,66,113,0,125,172,359,260,396,0,267,209,66,113,0,125,172,359
2024-10-30,21éû,565,202,363,0,267,209,0,88,0,125,172,268,202,363,0,267,209,0,88,0,125,172,268
2024-10-30,21éûîº,406,202,204,0,228,122,0,55,0,91,228,86,202,204,0,228,122,0,55,0,91,228,86
2024-10-30,22éû,289,146,143,0,143,61,0,84,0,121,143,25,146,143,0,143,61,0,84,0,121,143,25
2024-10-30,22éûîº,146,146,0,0,0,61,0,84,0,121,0,25,146,0,0,0,61,0,84,0,121,0,25
2024-10-30,23éû,149,149,0,0,0,61,32,55,0,91,0,58,149,0,0,0,61,32,55,0,91,0,58
2024-10-30,23éûîº,149,149,0,0,0,61,32,55,0,91,0,58,149,0,0,0,61,32,55,0,91,0,58
2024-10-30,24éû,149,149,0,0,0,61,32,55,0,29,0,120,149,0,0,0,61,32,55,0,29,0,120
2024-10-30,24éûîº,87,87,0,0,0,0,32,55,0,29,0,58,87,0,0,0,0,32,55,0,29,0,58
2024-10-30,25éû,55,55,0,0,0,0,0,55,0,29,0,25,55,0,0,0,0,0,55,0,29,0,25
2024-10-30,25éûîº,81,81,0,0,0,0,25,55,0,29,0,51,81,0,0,0,0,25,55,0,29,0,51
2024-10-30,26éû,81,81,0,0,0,0,25,55,0,29,0,51,81,0,0,0,0,25,55,0,29,0,51
2024-10-30,26éûîº,81,81,0,0,0,0,25,55,0,29,0,51,81,0,0,0,0,25,55,0,29,0,51
2024-10-30,27éû,137,137,0,0,82,0,0,55,0,112,0,25,137,0,0,82,0,0,55,0,112,0,25
2024-10-30,27éûîº,137,137,0,0,82,0,0,55,0,112,0,25,137,0,0,82,0,0,55,0,112,0,25
2024-10-30,28éû,137,137,0,0,82,0,0,55,0,112,0,25,137,0,0,82,0,0,55,0,112,0,25
2024-10-30,28éûîº,137,137,0,0,82,0,0,55,0,112,0,25,137,0,0,82,0,0,55,0,112,0,25
2024-10-31,5éû,0,0,0,0,0,0,0,0,0,0,0,0,0,0,0,0,0,0,0,0,0,0,0
2024-10-31,5éûîº,0,0,0,0,0,0,0,0,0,0,0,0,0,0,0,0,0,0,0,0,0,0,0
2024-10-31,6éû,122,122,0,0,0,61,60,0,0,0,0,122,122,0,0,0,61,60,0,0,0,0,122
2024-10-31,6éûîº,0,0,0,0,0,0,0,0,0,0,0,0,0,0,0,0,0,0,0,0,0,0,0
2024-10-31,7éû,0,0,0,0,0,0,0,0,0,0,0,0,0,0,0,0,0,0,0,0,0,0,0
2024-10-31,7éûîº,0,0,0,0,0,0,0,0,0,0,0,0,0,0,0,0,0,0,0,0,0,0,0
2024-10-31,8éû,251,150,101,0,163,61,26,0,0,0,163,88,150,101,0,163,61,26,0,0,0,163,88
2024-10-31,8éûîº,192,30,162,0,101,60,0,30,0,0,101,91,30,162,0,101,60,0,30,0,0,101,91
2024-10-31,9éû,162,0,162,0,101,60,0,0,0,0,101,60,0,162,0,101,60,0,0,0,0,101,60
2024-10-31,9éûîº,513,101,412,0,169,271,0,32,39,39,256,217,101,412,0,169,271,0,32,39,39,256,217
2024-10-31,10éû,1090,214,876,163,365,386,44,58,73,39,256,794,214,876,163,365,386,44,58,73,39,256,794
2024-10-31,10éûîº,947,162,785,163,365,281,44,60,33,0,256,691,162,785,163,365,281,44,60,33,0,256,691
2024-10-31,11éû,1483,288,1195,425,508,347,107,60,33,61,256,1164,288,1195,425,508,347,107,60,33,61,256,1164
2024-10-31,11éûîº,1280,254,1026,262,508,347,0,128,33,61,286,932,254,1026,262,508,347,0,128,33,61,286,932
2024-10-31,12éû,1133,309,824,0,597,295,0,201,39,61,375,697,309,824,0,597,295,0,201,39,61,375,697
2024-10-31,12éûîº,1564,439,1125,0,844,345,82,199,93,61,375,1127,439,1125,0,844,345,82,199,93,61,375,1127
2024-10-31,13éû,1217,304,913,0,755,208,115,98,39,61,169,986,304,913,0,755,208,115,98,39,61,169,986
2024-10-31,13éûîº,1436,332,1104,192,742,259,143,98,0,61,68,1305,332,1104,192,742,259,143,98,0,61,68,1305
2024-10-31,14éû,1807,295,1512,448,801,458,40,58,0,154,68,1584,295,1512,448,801,458,40,58,0,154,68,1584
2024-10-31,14éûîº,1791,295,1496,394,801,458,78,58,0,154,68,1568,295,1496,394,801,458,78,58,0,154,68,1568
2024-10-31,15éû,2956,454,2502,1030,1076,607,78,122,42,154,68,2733,454,2502,1030,1076,607,78,122,42,154,68,2733
2024-10-31,15éûîº,2641,508,2133,837,860,709,97,93,42,184,68,2389,508,2133,837,860,709,97,93,42,184,68,2389
2024-10-31,16éû,3224,574,2650,837,1264,670,229,178,42,250,101,2904,574,2650,837,1264,670,229,178,42,250,101,2904
2024-10-31,16éûîº,3929,547,3382,1108,1739,546,319,174,42,221,101,3640,547,3382,1108,1739,546,319,174,42,221,101,3640
2024-10-31,17éû,4409,600,3809,1300,1971,651,307,140,39,221,101,4121,600,3809,1300,1971,651,307,140,39,221,101,4121
2024-10-31,17éûîº,5070,649,4421,2019,1872,765,268,110,33,221,101,4781,649,4421,2019,1872,765,268,110,33,221,101,4781
2024-10-31,18éû,4532,763,3769,1836,1491,788,294,88,33,254,101,4211,763,3769,1836,1491,788,294,88,33,254,101,4211
2024-10-31,18éûîº,4132,650,3482,1836,1378,519,222,176,0,303,101,3761,650,3482,1836,1378,519,222,176,0,303,101,3761
2024-10-31,19éû,3600,648,2952,1438,1284,519,175,183,0,303,68,3228,648,2952,1438,1284,519,175,183,0,303,68,3228
2024-10-31,19éûîº,3651,433,3218,1703,1136,456,172,183,0,221,68,3361,433,3218,1703,1136,456,172,183,0,221,68,3361
2024-10-31,20éû,3491,403,3088,1703,1024,543,133,86,0,187,155,3148,403,3088,1703,1024,543,133,86,0,187,155,3148
2024-10-31,20éûîº,3836,437,3399,1936,1026,605,152,116,0,187,155,3494,437,3399,1936,1026,605,152,116,0,187,155,3494
2024-10-31,21éû,3300,412,2888,1797,871,500,69,61,0,280,155,2865,412,2888,1797,871,500,69,61,0,280,155,2865
2024-10-31,21éûîº,2910,393,2517,1797,595,456,0,61,0,363,86,2461,393,2517,1797,595,456,0,61,0,363,86,2461
2024-10-31,22éû,2140,378,1762,1153,484,441,0,61,0,363,86,1690,378,1762,1153,484,441,0,61,0,363,86,1690
2024-10-31,22éûîº,1369,200,1169,723,402,154,28,61,0,270,0,1099,200,1169,723,402,154,28,61,0,270,0,1099
2024-10-31,23éû,782,200,582,256,283,154,28,61,0,270,0,512,200,582,256,283,154,28,61,0,270,0,512
2024-10-31,23éûîº,718,337,381,392,82,154,28,61,0,407,0,312,337,381,392,82,154,28,61,0,407,0,312
2024-10-31,24éû,172,172,0,0,82,61,28,0,0,144,0,28,172,0,0,82,61,28,0,0,144,0,28
2024-10-31,24éûîº,110,110,0,0,82,0,28,0,0,82,0,28,110,0,0,82,0,28,0,0,82,0,28
2024-10-31,25éû,110,110,0,0,82,0,28,0,0,82,0,28,110,0,0,82,0,28,0,0,82,0,28
2024-10-31,25éûîº,110,110,0,0,82,0,28,0,0,82,0,28,110,0,0,82,0,28,0,0,82,0,28
2024-10-31,26éû,110,110,0,0,82,0,28,0,0,82,0,28,110,0,0,82,0,28,0,0,82,0,28
2024-10-31,26éûîº,82,82,0,0,82,0,0,0,0,82,0,0,82,0,0,82,0,0,0,0,82,0,0
2024-10-31,27éû,82,82,0,0,82,0,0,0,0,82,0,0,82,0,0,82,0,0,0,0,82,0,0
2024-10-31,27éûîº,82,82,0,0,82,0,0,0,0,82,0,0,82,0,0,82,0,0,0,0,82,0,0
2024-10-31,28éû,82,82,0,0,82,0,0,0,0,82,0,0,82,0,0,82,0,0,0,0,82,0,0
2024-10-31,28éûîº,82,82,0,0,82,0,0,0,0,82,0,0,82,0,0,82,0,0,0,0,82,0,0
