ì˙ït,éûä‘,çáåv,íjê´,èóê´,20ë„,30ë„,40ë„,50ë„,60ë„,70çŒà»è„,ãèèZé“,ãŒñ±é“,óàäXé“,ïΩãœíjê´,ïΩãœèóê´,ïΩãœ20ë„,ïΩãœ30ë„,ïΩãœ40ë„,ïΩãœ50ë„,ïΩãœ60ë„,ïΩãœ70çŒà»è„,ïΩãœãèèZé“,ïΩãœãŒñ±é“,ïΩãœóàäXé“
2024-10-01,5éû,32,32,0,0,0,0,32,0,0,0,0,32,32,0,0,0,0,32,0,0,0,0,32
2024-10-01,5éûîº,32,32,0,0,0,0,32,0,0,0,0,32,32,0,0,0,0,32,0,0,0,0,32
2024-10-01,6éû,32,32,0,0,0,0,32,0,0,0,0,32,32,0,0,0,0,32,0,0,0,0,32
2024-10-01,6éûîº,62,62,0,0,0,0,62,0,0,0,0,62,62,0,0,0,0,62,0,0,0,0,62
2024-10-01,7éû,32,32,0,0,0,0,32,0,0,0,0,32,32,0,0,0,0,32,0,0,0,0,32
2024-10-01,7éûîº,58,58,0,0,0,0,58,0,0,0,26,32,58,0,0,0,0,58,0,0,0,26,32
2024-10-01,8éû,358,87,271,271,0,0,87,0,0,0,297,60,87,271,271,0,0,87,0,0,0,297,60
2024-10-01,8éûîº,60,60,0,0,0,0,60,0,0,0,0,60,60,0,0,0,0,60,0,0,0,0,60
2024-10-01,9éû,126,92,34,0,0,0,101,25,0,0,0,127,92,34,0,0,0,101,25,0,0,0,127
2024-10-01,9éûîº,145,111,34,0,79,0,67,0,0,0,79,67,111,34,0,79,0,67,0,0,0,79,67
2024-10-01,10éû,113,79,34,0,79,0,34,0,0,0,79,34,79,34,0,79,0,34,0,0,0,79,34
2024-10-01,10éûîº,113,79,34,0,79,0,34,0,0,0,79,34,79,34,0,79,0,34,0,0,0,79,34
2024-10-01,11éû,79,79,0,0,79,0,0,0,0,0,79,0,79,0,0,79,0,0,0,0,0,79,0
2024-10-01,11éûîº,452,240,212,212,141,47,51,0,0,0,291,161,240,212,212,141,47,51,0,0,0,291,161
2024-10-01,12éû,537,325,212,320,141,47,27,0,0,0,291,245,325,212,320,141,47,27,0,0,0,291,245
2024-10-01,12éûîº,384,172,212,212,141,0,30,0,0,0,322,61,172,212,212,141,0,30,0,0,0,322,61
2024-10-01,13éû,558,346,212,334,141,51,30,0,0,0,322,235,346,212,334,141,51,30,0,0,0,322,235
2024-10-01,13éûîº,488,276,212,334,0,51,103,0,0,0,263,225,276,212,334,0,51,103,0,0,0,263,225
2024-10-01,14éû,212,0,212,212,0,0,0,0,0,0,212,0,0,212,212,0,0,0,0,0,0,212,0
2024-10-01,14éûîº,298,0,298,212,86,0,0,0,0,0,298,0,0,298,212,86,0,0,0,0,0,298,0
2024-10-01,15éû,298,0,298,212,86,0,0,0,0,0,298,0,0,298,212,86,0,0,0,0,0,298,0
2024-10-01,15éûîº,256,44,212,212,0,44,0,0,0,0,212,44,44,212,212,0,44,0,0,0,0,212,44
2024-10-01,16éû,60,60,0,0,0,60,0,0,0,0,0,60,60,0,0,0,60,0,0,0,0,0,60
2024-10-01,16éûîº,116,116,0,0,0,116,0,0,0,0,0,116,116,0,0,0,116,0,0,0,0,0,116
2024-10-01,17éû,55,55,0,0,0,55,0,0,0,0,0,55,55,0,0,0,55,0,0,0,0,0,55
2024-10-01,17éûîº,55,55,0,0,0,55,0,0,0,0,0,55,55,0,0,0,55,0,0,0,0,0,55
2024-10-01,18éû,92,55,37,0,0,55,37,0,0,0,0,93,55,37,0,0,55,37,0,0,0,0,93
2024-10-01,18éûîº,290,82,208,170,0,55,64,0,0,0,170,120,82,208,170,0,55,64,0,0,0,170,120
2024-10-01,19éû,347,82,265,170,94,55,26,0,0,0,265,82,82,265,170,94,55,26,0,0,0,265,82
2024-10-01,19éûîº,296,48,248,170,77,48,0,0,0,0,219,77,48,248,170,77,48,0,0,0,0,219,77
2024-10-01,20éû,248,0,248,170,77,0,0,0,0,0,170,77,0,248,170,77,0,0,0,0,0,170,77
2024-10-01,20éûîº,248,0,248,170,77,0,0,0,0,0,170,77,0,248,170,77,0,0,0,0,0,170,77
2024-10-01,21éû,385,89,296,385,0,0,0,0,0,0,170,214,89,296,385,0,0,0,0,0,0,170,214
2024-10-01,21éûîº,385,89,296,385,0,0,0,0,0,0,170,214,89,296,385,0,0,0,0,0,0,170,214
2024-10-01,22éû,656,89,567,656,0,0,0,0,0,0,170,485,89,567,656,0,0,0,0,0,0,170,485
2024-10-01,22éûîº,656,89,567,656,0,0,0,0,0,0,170,485,89,567,656,0,0,0,0,0,0,170,485
2024-10-01,23éû,464,168,296,385,79,0,0,0,0,0,250,214,168,296,385,79,0,0,0,0,0,250,214
2024-10-01,23éûîº,385,89,296,385,0,0,0,0,0,0,170,214,89,296,385,0,0,0,0,0,0,170,214
2024-10-01,24éû,302,89,213,214,0,0,0,0,88,0,0,302,89,213,214,0,0,0,0,88,0,0,302
2024-10-01,24éûîº,302,89,213,214,0,0,0,0,88,0,0,302,89,213,214,0,0,0,0,88,0,0,302
2024-10-01,25éû,302,89,213,214,0,0,0,0,88,0,0,302,89,213,214,0,0,0,0,88,0,0,302
2024-10-01,25éûîº,302,89,213,214,0,0,0,0,88,0,0,302,89,213,214,0,0,0,0,88,0,0,302
2024-10-01,26éû,302,89,213,214,0,0,0,0,88,0,0,302,89,213,214,0,0,0,0,88,0,0,302
2024-10-01,26éûîº,302,89,213,214,0,0,0,0,88,0,0,302,89,213,214,0,0,0,0,88,0,0,302
2024-10-01,27éû,213,0,213,125,0,0,0,0,88,0,0,213,0,213,125,0,0,0,0,88,0,0,213
2024-10-01,27éûîº,213,0,213,125,0,0,0,0,88,0,0,213,0,213,125,0,0,0,0,88,0,0,213
2024-10-01,28éû,213,0,213,125,0,0,0,0,88,0,0,213,0,213,125,0,0,0,0,88,0,0,213
2024-10-01,28éûîº,213,0,213,125,0,0,0,0,88,0,0,213,0,213,125,0,0,0,0,88,0,0,213
2024-10-02,5éû,125,0,125,125,0,0,0,0,0,0,0,125,0,125,125,0,0,0,0,0,0,0,125
2024-10-02,5éûîº,188,32,156,125,0,0,32,31,0,0,31,157,32,156,125,0,0,32,31,0,0,31,157
2024-10-02,6éû,63,32,31,0,0,0,32,31,0,0,31,32,32,31,0,0,0,32,31,0,0,31,32
2024-10-02,6éûîº,63,32,31,0,0,0,32,31,0,0,31,32,32,31,0,0,0,32,31,0,0,31,32
2024-10-02,7éû,63,32,31,0,0,0,32,31,0,0,31,32,32,31,0,0,0,32,31,0,0,31,32
2024-10-02,7éûîº,63,32,31,0,0,0,32,31,0,0,31,32,32,31,0,0,0,32,31,0,0,31,32
2024-10-02,8éû,140,109,31,0,0,46,62,31,0,0,78,62,109,31,0,0,46,62,31,0,0,78,62
2024-10-02,8éûîº,339,96,243,212,0,0,57,70,0,0,243,96,96,243,212,0,0,57,70,0,0,243,96
2024-10-02,9éû,562,319,243,434,0,0,57,70,0,0,354,208,319,243,434,0,0,57,70,0,0,354,208
2024-10-02,9éûîº,682,261,421,434,83,0,62,102,0,0,354,329,261,421,434,83,0,62,102,0,0,354,329
2024-10-02,10éû,677,150,527,322,213,0,37,102,0,0,354,323,150,527,322,213,0,37,102,0,0,354,323
2024-10-02,10éûîº,552,110,442,322,106,55,37,31,0,0,354,199,110,442,322,106,55,37,31,0,0,354,199
2024-10-02,11éû,414,133,281,322,0,0,37,54,0,0,354,60,133,281,322,0,0,37,54,0,0,354,60
2024-10-02,11éûîº,339,230,109,110,147,50,0,31,0,0,141,197,230,109,110,147,50,0,31,0,0,141,197
2024-10-02,12éû,440,331,109,110,147,50,28,31,72,0,141,298,331,109,110,147,50,28,31,72,0,141,298
2024-10-02,12éûîº,539,430,109,143,242,50,0,31,72,0,126,413,430,109,143,242,50,0,31,72,0,126,413
2024-10-02,13éû,533,424,109,143,242,55,0,50,41,0,182,351,424,109,143,242,55,0,50,41,0,182,351
2024-10-02,13éûîº,434,138,296,185,0,71,86,50,41,0,88,346,138,296,185,0,71,86,50,41,0,88,346
2024-10-02,14éû,397,132,265,185,0,115,36,18,41,0,36,361,132,265,185,0,115,36,18,41,0,36,361
2024-10-02,14éûîº,433,168,265,185,0,151,36,18,41,0,36,397,168,265,185,0,151,36,18,41,0,36,397
2024-10-02,15éû,274,46,228,185,0,71,0,18,0,0,0,275,46,228,185,0,71,0,18,0,0,0,275
2024-10-02,15éûîº,273,45,228,185,0,89,0,0,0,0,0,274,45,228,185,0,89,0,0,0,0,0,274
2024-10-02,16éû,275,0,275,185,0,49,0,0,41,0,0,275,0,275,185,0,49,0,0,41,0,0,275
2024-10-02,16éûîº,275,0,275,185,0,49,0,0,41,0,0,275,0,275,185,0,49,0,0,41,0,0,275
2024-10-02,17éû,376,111,265,185,62,49,26,52,0,0,0,376,111,265,185,62,49,26,52,0,0,0,376
2024-10-02,17éûîº,362,54,308,185,0,123,54,0,0,0,123,240,54,308,185,0,123,54,0,0,0,123,240
2024-10-02,18éû,437,54,383,185,0,123,54,33,41,0,123,315,54,383,185,0,123,54,33,41,0,123,315
2024-10-02,18éûîº,309,89,220,185,0,0,89,35,0,0,0,310,89,220,185,0,0,89,35,0,0,0,310
2024-10-02,19éû,118,89,29,0,0,0,119,0,0,0,0,119,89,29,0,0,0,119,0,0,0,0,119
2024-10-02,19éûîº,139,139,0,0,0,50,89,0,0,0,50,89,139,0,0,0,50,89,0,0,0,50,89
2024-10-02,20éû,89,89,0,0,0,0,89,0,0,0,0,89,89,0,0,0,0,89,0,0,0,0,89
2024-10-02,20éûîº,37,0,37,0,0,0,0,0,37,0,0,37,0,37,0,0,0,0,0,37,0,0,37
2024-10-02,21éû,176,139,37,139,0,0,0,0,37,0,0,176,139,37,139,0,0,0,0,37,0,0,176
2024-10-02,21éûîº,75,38,37,0,38,0,0,0,37,0,0,76,38,37,0,38,0,0,0,37,0,0,76
2024-10-02,22éû,75,38,37,0,38,0,0,0,37,0,0,76,38,37,0,38,0,0,0,37,0,0,76
2024-10-02,22éûîº,62,0,62,0,0,0,24,0,37,0,0,62,0,62,0,0,0,24,0,37,0,0,62
2024-10-02,23éû,90,28,62,0,0,0,53,0,37,0,0,91,28,62,0,0,0,53,0,37,0,0,91
2024-10-02,23éûîº,62,0,62,0,0,0,24,0,37,0,0,62,0,62,0,0,0,24,0,37,0,0,62
2024-10-02,24éû,24,0,24,0,0,0,24,0,0,0,0,24,0,24,0,0,0,24,0,0,0,0,24
2024-10-02,24éûîº,54,30,24,0,0,0,55,0,0,0,0,55,30,24,0,0,0,55,0,0,0,0,55
2024-10-02,25éû,24,0,24,0,0,0,24,0,0,0,0,24,0,24,0,0,0,24,0,0,0,0,24
2024-10-02,25éûîº,24,0,24,0,0,0,24,0,0,0,0,24,0,24,0,0,0,24,0,0,0,0,24
2024-10-02,26éû,24,0,24,0,0,0,24,0,0,0,0,24,0,24,0,0,0,24,0,0,0,0,24
2024-10-02,26éûîº,24,0,24,0,0,0,24,0,0,0,0,24,0,24,0,0,0,24,0,0,0,0,24
2024-10-02,27éû,24,0,24,0,0,0,24,0,0,0,0,24,0,24,0,0,0,24,0,0,0,0,24
2024-10-02,27éûîº,24,0,24,0,0,0,24,0,0,0,0,24,0,24,0,0,0,24,0,0,0,0,24
2024-10-02,28éû,24,0,24,0,0,0,24,0,0,0,0,24,0,24,0,0,0,24,0,0,0,0,24
2024-10-02,28éûîº,24,0,24,0,0,0,24,0,0,0,0,24,0,24,0,0,0,24,0,0,0,0,24
2024-10-03,5éû,0,0,0,0,0,0,0,0,0,0,0,0,0,0,0,0,0,0,0,0,0,0,0
2024-10-03,5éûîº,0,0,0,0,0,0,0,0,0,0,0,0,0,0,0,0,0,0,0,0,0,0,0
2024-10-03,6éû,0,0,0,0,0,0,0,0,0,0,0,0,0,0,0,0,0,0,0,0,0,0,0
2024-10-03,6éûîº,0,0,0,0,0,0,0,0,0,0,0,0,0,0,0,0,0,0,0,0,0,0,0
2024-10-03,7éû,179,93,86,0,86,93,0,0,0,0,86,93,93,86,0,86,93,0,0,0,0,86,93
2024-10-03,7éûîº,143,143,0,0,0,143,0,0,0,0,49,93,143,0,0,0,143,0,0,0,0,49,93
2024-10-03,8éû,228,228,0,0,127,101,0,0,0,0,110,118,228,0,0,127,101,0,0,0,0,110,118
2024-10-03,8éûîº,214,214,0,0,66,113,34,0,0,0,0,214,214,0,0,66,113,34,0,0,0,0,214
2024-10-03,9éû,277,100,177,177,0,42,57,0,0,0,23,254,100,177,177,0,42,57,0,0,0,23,254
2024-10-03,9éûîº,85,85,0,0,40,0,23,21,0,0,23,62,85,0,0,40,0,23,21,0,0,23,62
2024-10-03,10éû,188,155,33,0,40,60,57,0,30,0,23,166,155,33,0,40,60,57,0,30,0,23,166
2024-10-03,10éûîº,64,64,0,0,40,0,23,0,0,0,23,40,64,0,0,40,0,23,0,0,0,23,40
2024-10-03,11éû,70,70,0,0,40,0,29,0,0,0,0,70,70,0,0,40,0,29,0,0,0,0,70
2024-10-03,11éûîº,225,186,39,0,40,60,29,0,95,0,0,226,186,39,0,40,60,29,0,95,0,0,226
2024-10-03,12éû,748,411,337,297,40,261,84,0,64,0,54,693,411,337,297,40,261,84,0,64,0,54,693
2024-10-03,12éûîº,643,346,297,297,40,254,27,0,24,0,0,644,346,297,297,40,254,27,0,24,0,0,644
2024-10-03,13éû,575,278,297,297,40,206,0,0,30,0,0,575,278,297,297,40,206,0,0,30,0,0,575
2024-10-03,13éûîº,769,196,573,509,114,125,20,0,0,0,232,537,196,573,509,114,125,20,0,0,0,232,537
2024-10-03,14éû,801,292,509,509,114,157,20,0,0,0,279,522,292,509,509,114,157,20,0,0,0,279,522
2024-10-03,14éûîº,496,284,212,334,114,46,0,0,0,0,258,237,284,212,334,114,46,0,0,0,0,258,237
2024-10-03,15éû,334,122,212,212,40,27,54,0,0,0,212,122,122,212,212,40,27,54,0,0,0,212,122
2024-10-03,15éûîº,280,40,240,212,40,0,0,28,0,0,212,69,40,240,212,40,0,0,28,0,0,212,69
2024-10-03,16éû,301,89,212,212,40,48,0,0,0,0,212,89,89,212,212,40,48,0,0,0,0,212,89
2024-10-03,16éûîº,89,89,0,0,40,48,0,0,0,0,0,89,89,0,0,40,48,0,0,0,0,0,89
2024-10-03,17éû,170,97,73,0,170,0,0,0,0,0,0,170,97,73,0,170,0,0,0,0,0,0,170
2024-10-03,17éûîº,277,204,73,0,238,40,0,0,0,0,0,278,204,73,0,238,40,0,0,0,0,0,278
2024-10-03,18éû,316,243,73,0,276,40,0,0,0,0,0,317,243,73,0,276,40,0,0,0,0,0,317
2024-10-03,18éûîº,208,135,73,0,168,40,0,0,0,0,0,208,135,73,0,168,40,0,0,0,0,0,208
2024-10-03,19éû,256,119,137,0,129,104,22,0,0,0,64,192,119,137,0,129,104,22,0,0,0,64,192
2024-10-03,19éûîº,136,63,73,0,73,40,22,0,0,0,0,136,63,73,0,73,40,22,0,0,0,0,136
2024-10-03,20éû,280,207,73,0,147,40,57,36,0,0,0,280,207,73,0,147,40,57,36,0,0,0,280
2024-10-03,20éûîº,146,73,73,0,147,0,0,0,0,0,0,147,73,73,0,147,0,0,0,0,0,0,147
2024-10-03,21éû,197,124,73,0,147,50,0,0,0,0,0,197,124,73,0,147,50,0,0,0,0,0,197
2024-10-03,21éûîº,197,124,73,0,147,50,0,0,0,0,0,197,124,73,0,147,50,0,0,0,0,0,197
2024-10-03,22éû,197,124,73,0,147,50,0,0,0,0,0,197,124,73,0,147,50,0,0,0,0,0,197
2024-10-03,22éûîº,146,73,73,0,147,0,0,0,0,0,0,147,73,73,0,147,0,0,0,0,0,0,147
2024-10-03,23éû,73,73,0,0,73,0,0,0,0,0,0,73,73,0,0,73,0,0,0,0,0,0,73
2024-10-03,23éûîº,129,129,0,0,129,0,0,0,0,0,0,129,129,0,0,129,0,0,0,0,0,0,129
2024-10-03,24éû,263,173,90,99,163,0,0,0,0,0,0,263,173,90,99,163,0,0,0,0,0,0,263
2024-10-03,24éûîº,263,173,90,99,163,0,0,0,0,0,0,263,173,90,99,163,0,0,0,0,0,0,263
2024-10-03,25éû,263,173,90,99,163,0,0,0,0,0,0,263,173,90,99,163,0,0,0,0,0,0,263
2024-10-03,25éûîº,263,173,90,99,163,0,0,0,0,0,0,263,173,90,99,163,0,0,0,0,0,0,263
2024-10-03,26éû,263,173,90,99,163,0,0,0,0,0,0,263,173,90,99,163,0,0,0,0,0,0,263
2024-10-03,26éûîº,263,173,90,99,163,0,0,0,0,0,0,263,173,90,99,163,0,0,0,0,0,0,263
2024-10-03,27éû,263,173,90,99,163,0,0,0,0,0,0,263,173,90,99,163,0,0,0,0,0,0,263
2024-10-03,27éûîº,263,173,90,99,163,0,0,0,0,0,0,263,173,90,99,163,0,0,0,0,0,0,263
2024-10-03,28éû,263,173,90,99,163,0,0,0,0,0,0,263,173,90,99,163,0,0,0,0,0,0,263
2024-10-03,28éûîº,163,73,90,0,163,0,0,0,0,0,0,163,73,90,0,163,0,0,0,0,0,0,163
2024-10-04,5éû,283,111,172,0,146,54,24,57,0,0,0,284,111,172,0,146,54,24,57,0,0,0,284
2024-10-04,5éûîº,283,111,172,0,146,54,24,57,0,0,0,284,111,172,0,146,54,24,57,0,0,0,284
2024-10-04,6éû,136,54,82,0,0,54,24,57,0,0,0,137,54,82,0,0,54,24,57,0,0,0,137
2024-10-04,6éûîº,136,54,82,0,0,54,24,57,0,0,0,137,54,82,0,0,54,24,57,0,0,0,137
2024-10-04,7éû,136,54,82,0,0,54,24,57,0,0,0,137,54,82,0,0,54,24,57,0,0,0,137
2024-10-04,7éûîº,192,54,138,0,0,54,24,57,55,0,55,137,54,138,0,0,54,24,57,55,0,55,137
2024-10-04,8éû,406,324,82,0,184,54,110,57,0,0,64,343,324,82,0,184,54,110,57,0,0,64,343
2024-10-04,8éûîº,211,129,82,0,47,0,106,57,0,0,29,182,129,82,0,47,0,106,57,0,0,29,182
2024-10-04,9éû,224,142,82,0,111,0,55,57,0,0,0,225,142,82,0,111,0,55,57,0,0,0,225
2024-10-04,9éûîº,161,104,57,0,63,40,0,57,0,0,0,161,104,57,0,63,40,0,57,0,0,0,161
2024-10-04,10éû,120,63,57,0,63,0,0,57,0,0,0,121,63,57,0,63,0,0,57,0,0,0,121
2024-10-04,10éûîº,147,0,147,0,90,0,0,57,0,0,0,147,0,147,0,90,0,0,57,0,0,0,147
2024-10-04,11éû,28,0,28,0,0,0,0,28,0,0,0,28,0,28,0,0,0,0,28,0,0,0,28
2024-10-04,11éûîº,77,77,0,0,47,0,0,29,0,0,0,77,77,0,0,47,0,0,29,0,0,0,77
2024-10-04,12éû,431,109,322,224,47,64,66,29,0,0,0,432,109,322,224,47,64,66,29,0,0,0,432
2024-10-04,12éûîº,194,130,64,0,0,64,63,24,41,0,0,195,130,64,0,0,64,63,24,41,0,0,195
2024-10-04,13éû,73,41,32,0,0,32,0,0,41,0,0,74,41,32,0,0,32,0,0,41,0,0,74
2024-10-04,13éûîº,73,41,32,0,0,32,0,0,41,0,0,74,41,32,0,0,32,0,0,41,0,0,74
2024-10-04,14éû,114,41,73,0,73,0,0,0,41,0,0,115,41,73,0,73,0,0,0,41,0,0,115
2024-10-04,14éûîº,114,41,73,0,73,0,0,0,41,0,0,115,41,73,0,73,0,0,0,41,0,0,115
2024-10-04,15éû,0,0,0,0,0,0,0,0,0,0,0,0,0,0,0,0,0,0,0,0,0,0,0
2024-10-04,15éûîº,53,53,0,0,0,53,0,0,0,0,0,53,53,0,0,0,53,0,0,0,0,0,53
2024-10-04,16éû,112,112,0,0,0,53,58,0,0,0,0,112,112,0,0,0,53,58,0,0,0,0,112
2024-10-04,16éûîº,111,111,0,0,0,53,57,0,0,0,0,111,111,0,0,0,53,57,0,0,0,0,111
2024-10-04,17éû,86,53,33,0,0,53,33,0,0,0,0,87,53,33,0,0,53,33,0,0,0,0,87
2024-10-04,17éûîº,96,0,96,0,0,0,33,62,0,0,0,96,0,96,0,0,0,33,62,0,0,0,96
2024-10-04,18éû,124,58,66,0,0,58,33,32,0,0,0,124,58,66,0,0,58,33,32,0,0,0,124
2024-10-04,18éûîº,509,39,470,403,0,0,33,72,0,0,39,470,39,470,403,0,0,33,72,0,0,39,470
2024-10-04,19éû,134,102,32,0,57,45,0,32,0,0,45,89,102,32,0,57,45,0,32,0,0,45,89
2024-10-04,19éûîº,134,102,32,0,57,45,0,32,0,0,45,89,102,32,0,57,45,0,32,0,0,45,89
2024-10-04,20éû,45,45,0,0,0,45,0,0,0,0,45,0,45,0,0,0,45,0,0,0,0,45,0
2024-10-04,20éûîº,45,45,0,0,0,45,0,0,0,0,45,0,45,0,0,0,45,0,0,0,0,45,0
2024-10-04,21éû,45,45,0,0,0,45,0,0,0,0,45,0,45,0,0,0,45,0,0,0,0,45,0
2024-10-04,21éûîº,105,105,0,0,0,105,0,0,0,60,45,0,105,0,0,0,105,0,0,0,60,45,0
2024-10-04,22éû,133,105,28,0,0,105,0,28,0,60,45,28,105,28,0,0,105,0,28,0,60,45,28
2024-10-04,22éûîº,102,45,57,0,0,45,0,57,0,0,45,57,45,57,0,0,45,0,57,0,0,45,57
2024-10-04,23éû,102,45,57,0,0,45,0,57,0,0,45,57,45,57,0,0,45,0,57,0,0,45,57
2024-10-04,23éûîº,29,0,29,0,0,0,0,29,0,0,0,29,0,29,0,0,0,0,29,0,0,0,29
2024-10-04,24éû,29,0,29,0,0,0,0,29,0,0,0,29,0,29,0,0,0,0,29,0,0,0,29
2024-10-04,24éûîº,57,0,57,0,0,0,0,57,0,0,0,57,0,57,0,0,0,0,57,0,0,0,57
2024-10-04,25éû,111,54,57,0,0,54,0,57,0,0,0,112,54,57,0,0,54,0,57,0,0,0,112
2024-10-04,25éûîº,111,54,57,0,0,54,0,57,0,0,0,112,54,57,0,0,54,0,57,0,0,0,112
2024-10-04,26éû,111,54,57,0,0,54,0,57,0,0,0,112,54,57,0,0,54,0,57,0,0,0,112
2024-10-04,26éûîº,111,54,57,0,0,54,0,57,0,0,0,112,54,57,0,0,54,0,57,0,0,0,112
2024-10-04,27éû,111,54,57,0,0,54,0,57,0,0,0,112,54,57,0,0,54,0,57,0,0,0,112
2024-10-04,27éûîº,111,54,57,0,0,54,0,57,0,0,0,112,54,57,0,0,54,0,57,0,0,0,112
2024-10-04,28éû,111,54,57,0,0,54,0,57,0,0,0,112,54,57,0,0,54,0,57,0,0,0,112
2024-10-04,28éûîº,111,54,57,0,0,54,0,57,0,0,0,112,54,57,0,0,54,0,57,0,0,0,112
2024-10-05,5éû,0,0,0,0,0,0,0,0,0,0,0,0,0,0,0,0,0,0,0,0,0,0,0
2024-10-05,5éûîº,0,0,0,0,0,0,0,0,0,0,0,0,0,0,0,0,0,0,0,0,0,0,0
2024-10-05,6éû,0,0,0,0,0,0,0,0,0,0,0,0,0,0,0,0,0,0,0,0,0,0,0
2024-10-05,6éûîº,0,0,0,0,0,0,0,0,0,0,0,0,0,0,0,0,0,0,0,0,0,0,0
2024-10-05,7éû,31,31,0,0,0,0,31,0,0,0,0,31,31,0,0,0,0,31,0,0,0,0,31
2024-10-05,7éûîº,63,0,63,0,0,63,0,0,0,0,0,63,0,63,0,0,63,0,0,0,0,0,63
2024-10-05,8éû,0,0,0,0,0,0,0,0,0,0,0,0,0,0,0,0,0,0,0,0,0,0,0
2024-10-05,8éûîº,38,0,38,0,0,0,0,0,38,0,0,38,0,38,0,0,0,0,0,38,0,0,38
2024-10-05,9éû,27,27,0,0,0,0,0,27,0,0,0,27,27,0,0,0,0,0,27,0,0,0,27
2024-10-05,9éûîº,27,27,0,0,0,0,0,27,0,0,0,27,27,0,0,0,0,0,27,0,0,0,27
2024-10-05,10éû,307,51,256,256,0,51,0,0,0,0,0,307,51,256,256,0,51,0,0,0,0,0,307
2024-10-05,10éûîº,212,0,212,212,0,0,0,0,0,0,212,0,0,212,212,0,0,0,0,0,0,212,0
2024-10-05,11éû,239,0,239,212,0,0,27,0,0,0,212,27,0,239,212,0,0,27,0,0,0,212,27
2024-10-05,11éûîº,239,0,239,212,0,0,27,0,0,0,212,27,0,239,212,0,0,27,0,0,0,212,27
2024-10-05,12éû,239,0,239,212,0,0,27,0,0,0,212,27,0,239,212,0,0,27,0,0,0,212,27
2024-10-05,12éûîº,315,103,212,212,0,103,0,0,0,0,212,103,103,212,212,0,103,0,0,0,0,212,103
2024-10-05,13éû,315,103,212,212,0,103,0,0,0,0,212,103,103,212,212,0,103,0,0,0,0,212,103
2024-10-05,13éûîº,315,103,212,212,0,103,0,0,0,0,212,103,103,212,212,0,103,0,0,0,0,212,103
2024-10-05,14éû,212,0,212,212,0,0,0,0,0,0,212,0,0,212,212,0,0,0,0,0,0,212,0
2024-10-05,14éûîº,312,0,312,212,68,0,31,0,0,0,212,100,0,312,212,68,0,31,0,0,0,212,100
2024-10-05,15éû,279,67,212,212,67,0,0,0,0,0,212,67,67,212,212,67,0,0,0,0,0,212,67
2024-10-05,15éûîº,315,67,248,212,67,0,36,0,0,0,212,104,67,248,212,67,0,36,0,0,0,212,104
2024-10-05,16éû,103,67,36,0,67,0,36,0,0,0,0,104,67,36,0,67,0,36,0,0,0,0,104
2024-10-05,16éûîº,37,37,0,0,0,0,37,0,0,0,0,37,37,0,0,0,0,37,0,0,0,0,37
2024-10-05,17éû,37,37,0,0,0,0,37,0,0,0,0,37,37,0,0,0,0,37,0,0,0,0,37
2024-10-05,17éûîº,43,43,0,0,0,43,0,0,0,0,0,43,43,0,0,0,43,0,0,0,0,0,43
2024-10-05,18éû,74,74,0,0,50,0,23,0,0,0,0,74,74,0,0,50,0,23,0,0,0,0,74
2024-10-05,18éûîº,74,74,0,0,50,0,23,0,0,0,0,74,74,0,0,50,0,23,0,0,0,0,74
2024-10-05,19éû,115,74,41,0,50,0,65,0,0,0,0,116,74,41,0,50,0,65,0,0,0,0,116
2024-10-05,19éûîº,221,116,105,0,116,63,41,0,0,0,0,222,116,105,0,116,63,41,0,0,0,0,222
2024-10-05,20éû,281,116,165,0,116,123,41,0,0,0,0,282,116,165,0,116,123,41,0,0,0,0,282
2024-10-05,20éûîº,175,116,59,0,116,59,0,0,0,0,0,176,116,59,0,116,59,0,0,0,0,0,176
2024-10-05,21éû,280,178,102,61,116,59,0,42,0,0,0,280,178,102,61,116,59,0,42,0,0,0,280
2024-10-05,21éûîº,220,178,42,0,116,61,0,42,0,0,0,221,178,42,0,116,61,0,42,0,0,0,221
2024-10-05,22éû,356,314,42,135,116,61,0,42,0,0,0,357,314,42,135,116,61,0,42,0,0,0,357
2024-10-05,22éûîº,158,116,42,0,116,0,0,42,0,0,0,159,116,42,0,116,0,0,42,0,0,0,159
2024-10-05,23éû,158,116,42,0,116,0,0,42,0,0,0,159,116,42,0,116,0,0,42,0,0,0,159
2024-10-05,23éûîº,201,116,85,0,116,43,0,42,0,0,0,202,116,85,0,116,43,0,42,0,0,0,202
2024-10-05,24éû,163,78,85,0,50,43,27,42,0,0,0,163,78,85,0,50,43,27,42,0,0,0,163
2024-10-05,24éûîº,163,78,85,0,50,43,27,42,0,0,0,163,78,85,0,50,43,27,42,0,0,0,163
2024-10-05,25éû,202,117,85,66,50,43,0,42,0,0,0,203,117,85,66,50,43,0,42,0,0,0,203
2024-10-05,25éûîº,202,117,85,66,50,43,0,42,0,0,0,203,117,85,66,50,43,0,42,0,0,0,203
2024-10-05,26éû,202,117,85,66,50,43,0,42,0,0,0,203,117,85,66,50,43,0,42,0,0,0,203
2024-10-05,26éûîº,202,117,85,66,50,43,0,42,0,0,0,203,117,85,66,50,43,0,42,0,0,0,203
2024-10-05,27éû,202,117,85,66,50,43,0,42,0,0,0,203,117,85,66,50,43,0,42,0,0,0,203
2024-10-05,27éûîº,202,117,85,66,50,43,0,42,0,0,0,203,117,85,66,50,43,0,42,0,0,0,203
2024-10-05,28éû,202,117,85,66,50,43,0,42,0,0,0,203,117,85,66,50,43,0,42,0,0,0,203
2024-10-05,28éûîº,257,172,85,66,50,43,54,42,0,0,0,258,172,85,66,50,43,54,42,0,0,0,258
2024-10-06,5éû,140,54,86,0,0,86,54,0,0,0,0,141,54,86,0,0,86,54,0,0,0,0,141
2024-10-06,5éûîº,128,54,74,0,0,43,54,31,0,0,31,98,54,74,0,0,43,54,31,0,0,31,98
2024-10-06,6éû,128,54,74,0,0,43,54,31,0,0,31,98,54,74,0,0,43,54,31,0,0,31,98
2024-10-06,6éûîº,128,54,74,0,0,43,54,31,0,0,31,98,54,74,0,0,43,54,31,0,0,31,98
2024-10-06,7éû,211,137,74,0,82,43,54,31,0,0,31,180,137,74,0,82,43,54,31,0,0,31,180
2024-10-06,7éûîº,193,150,43,0,0,138,54,0,0,0,0,193,150,43,0,0,138,54,0,0,0,0,193
2024-10-06,8éû,43,0,43,0,0,43,0,0,0,0,0,43,0,43,0,0,43,0,0,0,0,0,43
2024-10-06,8éûîº,67,24,43,0,0,43,0,24,0,0,0,68,24,43,0,0,43,0,24,0,0,0,68
2024-10-06,9éû,67,24,43,0,0,43,0,24,0,0,0,68,24,43,0,0,43,0,24,0,0,0,68
2024-10-06,9éûîº,150,107,43,0,52,97,0,0,0,0,0,150,107,43,0,52,97,0,0,0,0,0,150
2024-10-06,10éû,95,21,74,0,0,43,21,31,0,0,31,64,21,74,0,0,43,21,31,0,0,31,64
2024-10-06,10éûîº,74,0,74,0,0,74,0,0,0,0,0,74,0,74,0,0,74,0,0,0,0,0,74
2024-10-06,11éû,74,0,74,0,0,74,0,0,0,0,0,74,0,74,0,0,74,0,0,0,0,0,74
2024-10-06,11éûîº,113,58,55,0,0,0,58,55,0,0,0,114,58,55,0,0,0,58,55,0,0,0,114
2024-10-06,12éû,58,58,0,0,0,0,58,0,0,0,0,58,58,0,0,0,0,58,0,0,0,0,58
2024-10-06,12éûîº,0,0,0,0,0,0,0,0,0,0,0,0,0,0,0,0,0,0,0,0,0,0,0
2024-10-06,13éû,0,0,0,0,0,0,0,0,0,0,0,0,0,0,0,0,0,0,0,0,0,0,0
2024-10-06,13éûîº,0,0,0,0,0,0,0,0,0,0,0,0,0,0,0,0,0,0,0,0,0,0,0
2024-10-06,14éû,84,0,84,0,0,0,31,0,52,0,0,84,0,84,0,0,0,31,0,52,0,0,84
2024-10-06,14éûîº,63,0,63,0,0,0,63,0,0,0,0,63,0,63,0,0,0,63,0,0,0,0,63
2024-10-06,15éû,31,0,31,0,0,0,31,0,0,0,0,31,0,31,0,0,0,31,0,0,0,0,31
2024-10-06,15éûîº,31,0,31,0,0,0,31,0,0,0,0,31,0,31,0,0,0,31,0,0,0,0,31
2024-10-06,16éû,31,0,31,0,0,0,31,0,0,0,0,31,0,31,0,0,0,31,0,0,0,0,31
2024-10-06,16éûîº,107,0,107,0,0,107,0,0,0,0,0,107,0,107,0,0,107,0,0,0,0,0,107
2024-10-06,17éû,139,32,107,0,0,107,0,32,0,0,32,107,32,107,0,0,107,0,32,0,0,32,107
2024-10-06,17éûîº,292,185,107,109,0,149,0,32,0,0,32,259,185,107,109,0,149,0,32,0,0,32,259
2024-10-06,18éû,259,152,107,109,0,149,0,0,0,0,0,259,152,107,109,0,149,0,0,0,0,0,259
2024-10-06,18éûîº,186,79,107,0,79,107,0,0,0,79,0,107,79,107,0,79,107,0,0,0,79,0,107
2024-10-06,19éû,209,102,107,0,79,107,23,0,0,79,0,130,102,107,0,79,107,23,0,0,79,0,130
2024-10-06,19éûîº,130,23,107,0,0,107,23,0,0,0,0,130,23,107,0,0,107,23,0,0,0,0,130
2024-10-06,20éû,107,0,107,0,0,107,0,0,0,0,0,107,0,107,0,0,107,0,0,0,0,0,107
2024-10-06,20éûîº,43,0,43,0,0,43,0,0,0,0,0,43,0,43,0,0,43,0,0,0,0,0,43
2024-10-06,21éû,43,0,43,0,0,43,0,0,0,0,0,43,0,43,0,0,43,0,0,0,0,0,43
2024-10-06,21éûîº,43,0,43,0,0,43,0,0,0,0,0,43,0,43,0,0,43,0,0,0,0,0,43
2024-10-06,22éû,43,0,43,0,0,43,0,0,0,0,0,43,0,43,0,0,43,0,0,0,0,0,43
2024-10-06,22éûîº,43,0,43,0,0,43,0,0,0,0,0,43,0,43,0,0,43,0,0,0,0,0,43
2024-10-06,23éû,43,0,43,0,0,43,0,0,0,0,0,43,0,43,0,0,43,0,0,0,0,0,43
2024-10-06,23éûîº,43,0,43,0,0,43,0,0,0,0,0,43,0,43,0,0,43,0,0,0,0,0,43
2024-10-06,24éû,0,0,0,0,0,0,0,0,0,0,0,0,0,0,0,0,0,0,0,0,0,0,0
2024-10-06,24éûîº,0,0,0,0,0,0,0,0,0,0,0,0,0,0,0,0,0,0,0,0,0,0,0
2024-10-06,25éû,0,0,0,0,0,0,0,0,0,0,0,0,0,0,0,0,0,0,0,0,0,0,0
2024-10-06,25éûîº,0,0,0,0,0,0,0,0,0,0,0,0,0,0,0,0,0,0,0,0,0,0,0
2024-10-06,26éû,0,0,0,0,0,0,0,0,0,0,0,0,0,0,0,0,0,0,0,0,0,0,0
2024-10-06,26éûîº,0,0,0,0,0,0,0,0,0,0,0,0,0,0,0,0,0,0,0,0,0,0,0
2024-10-06,27éû,0,0,0,0,0,0,0,0,0,0,0,0,0,0,0,0,0,0,0,0,0,0,0
2024-10-06,27éûîº,0,0,0,0,0,0,0,0,0,0,0,0,0,0,0,0,0,0,0,0,0,0,0
2024-10-06,28éû,43,0,43,0,0,43,0,0,0,0,0,43,0,43,0,0,43,0,0,0,0,0,43
2024-10-06,28éûîº,43,0,43,0,0,43,0,0,0,0,0,43,0,43,0,0,43,0,0,0,0,0,43
2024-10-07,5éû,32,32,0,0,0,0,32,0,0,0,0,32,32,0,0,0,0,32,0,0,0,0,32
2024-10-07,5éûîº,32,32,0,0,0,0,32,0,0,0,0,32,32,0,0,0,0,32,0,0,0,0,32
2024-10-07,6éû,92,92,0,0,0,60,32,0,0,0,0,92,92,0,0,0,60,32,0,0,0,0,92
2024-10-07,6éûîº,32,32,0,0,0,0,32,0,0,0,0,32,32,0,0,0,0,32,0,0,0,0,32
2024-10-07,7éû,170,170,0,138,0,0,32,0,0,0,0,170,170,0,138,0,0,32,0,0,0,0,170
2024-10-07,7éûîº,303,303,0,138,0,61,67,36,0,0,36,266,303,0,138,0,61,67,36,0,0,36,266
2024-10-07,8éû,167,167,0,0,38,61,67,0,0,0,0,167,167,0,0,38,61,67,0,0,0,0,167
2024-10-07,8éûîº,32,32,0,0,0,0,32,0,0,0,0,32,32,0,0,0,0,32,0,0,0,0,32
2024-10-07,9éû,32,32,0,0,0,0,32,0,0,0,0,32,32,0,0,0,0,32,0,0,0,0,32
2024-10-07,9éûîº,63,32,31,0,0,0,32,31,0,0,31,32,32,31,0,0,0,32,31,0,0,31,32
2024-10-07,10éû,0,0,0,0,0,0,0,0,0,0,0,0,0,0,0,0,0,0,0,0,0,0,0
2024-10-07,10éûîº,0,0,0,0,0,0,0,0,0,0,0,0,0,0,0,0,0,0,0,0,0,0,0
2024-10-07,11éû,0,0,0,0,0,0,0,0,0,0,0,0,0,0,0,0,0,0,0,0,0,0,0
2024-10-07,11éûîº,102,71,31,0,0,0,71,31,0,0,31,71,71,31,0,0,0,71,31,0,0,31,71
2024-10-07,12éû,102,71,31,0,0,0,71,31,0,0,31,71,71,31,0,0,0,71,31,0,0,31,71
2024-10-07,12éûîº,31,0,31,0,0,0,0,31,0,0,31,0,0,31,0,0,0,0,31,0,0,31,0
2024-10-07,13éû,31,0,31,0,0,0,0,31,0,0,31,0,0,31,0,0,0,0,31,0,0,31,0
2024-10-07,13éûîº,103,37,66,0,0,37,0,66,0,0,66,37,37,66,0,0,37,0,66,0,0,66,37
2024-10-07,14éû,60,29,31,0,0,0,0,31,29,0,31,29,29,31,0,0,0,0,31,29,0,31,29
2024-10-07,14éûîº,0,0,0,0,0,0,0,0,0,0,0,0,0,0,0,0,0,0,0,0,0,0,0
2024-10-07,15éû,63,0,63,0,0,63,0,0,0,0,0,63,0,63,0,0,63,0,0,0,0,0,63
2024-10-07,15éûîº,63,0,63,0,0,63,0,0,0,0,0,63,0,63,0,0,63,0,0,0,0,0,63
2024-10-07,16éû,30,30,0,0,0,0,30,0,0,0,0,30,30,0,0,0,0,30,0,0,0,0,30
2024-10-07,16éûîº,103,60,43,0,0,104,0,0,0,0,0,104,60,43,0,0,104,0,0,0,0,0,104
2024-10-07,17éû,148,105,43,0,0,149,0,0,0,0,0,149,105,43,0,0,149,0,0,0,0,0,149
2024-10-07,17éûîº,138,95,43,0,0,104,34,0,0,0,0,138,95,43,0,0,104,34,0,0,0,0,138
2024-10-07,18éû,164,121,43,0,0,164,0,0,0,0,0,164,121,43,0,0,164,0,0,0,0,0,164
2024-10-07,18éûîº,60,60,0,0,0,60,0,0,0,0,0,60,60,0,0,0,60,0,0,0,0,0,60
2024-10-07,19éû,213,213,0,128,0,60,0,24,0,0,0,213,213,0,128,0,60,0,24,0,0,0,213
2024-10-07,19éûîº,213,213,0,128,0,60,0,24,0,0,0,213,213,0,128,0,60,0,24,0,0,0,213
2024-10-07,20éû,188,188,0,128,0,60,0,0,0,0,0,188,188,0,128,0,60,0,0,0,0,0,188
2024-10-07,20éûîº,60,60,0,0,0,60,0,0,0,0,0,60,60,0,0,0,60,0,0,0,0,0,60
2024-10-07,21éû,153,110,43,0,0,154,0,0,0,0,0,154,110,43,0,0,154,0,0,0,0,0,154
2024-10-07,21éûîº,128,85,43,0,0,104,24,0,0,0,0,128,85,43,0,0,104,24,0,0,0,0,128
2024-10-07,22éû,613,85,528,484,0,104,24,0,0,0,0,613,85,528,484,0,104,24,0,0,0,0,613
2024-10-07,22éûîº,103,60,43,0,0,104,0,0,0,0,0,104,60,43,0,0,104,0,0,0,0,0,104
2024-10-07,23éû,103,60,43,0,0,104,0,0,0,0,0,104,60,43,0,0,104,0,0,0,0,0,104
2024-10-07,23éûîº,103,60,43,0,0,104,0,0,0,0,0,104,60,43,0,0,104,0,0,0,0,0,104
2024-10-07,24éû,95,24,71,0,0,43,0,52,0,0,0,96,24,71,0,0,43,0,52,0,0,0,96
2024-10-07,24éûîº,95,24,71,0,0,43,0,52,0,0,0,96,24,71,0,0,43,0,52,0,0,0,96
2024-10-07,25éû,95,24,71,0,0,43,0,52,0,0,0,96,24,71,0,0,43,0,52,0,0,0,96
2024-10-07,25éûîº,95,24,71,0,0,43,0,52,0,0,0,96,24,71,0,0,43,0,52,0,0,0,96
2024-10-07,26éû,52,24,28,0,0,0,0,52,0,0,0,52,24,28,0,0,0,0,52,0,0,0,52
2024-10-07,26éûîº,95,24,71,0,0,43,0,52,0,0,0,96,24,71,0,0,43,0,52,0,0,0,96
2024-10-07,27éû,95,24,71,0,0,43,0,52,0,0,0,96,24,71,0,0,43,0,52,0,0,0,96
2024-10-07,27éûîº,95,24,71,0,0,43,0,52,0,0,0,96,24,71,0,0,43,0,52,0,0,0,96
2024-10-07,28éû,95,24,71,0,0,43,0,52,0,0,0,96,24,71,0,0,43,0,52,0,0,0,96
2024-10-07,28éûîº,95,24,71,0,0,43,0,52,0,0,0,96,24,71,0,0,43,0,52,0,0,0,96
2024-10-08,5éû,84,56,28,0,0,0,32,52,0,0,0,84,56,28,0,0,0,32,52,0,0,0,84
2024-10-08,5éûîº,84,56,28,0,0,0,32,52,0,0,0,84,56,28,0,0,0,32,52,0,0,0,84
2024-10-08,6éû,32,32,0,0,0,0,32,0,0,0,0,32,32,0,0,0,0,32,0,0,0,0,32
2024-10-08,6éûîº,32,32,0,0,0,0,32,0,0,0,0,32,32,0,0,0,0,32,0,0,0,0,32
2024-10-08,7éû,62,62,0,0,0,0,62,0,0,0,0,62,62,0,0,0,0,62,0,0,0,0,62
2024-10-08,7éûîº,62,62,0,0,0,0,62,0,0,0,0,62,62,0,0,0,0,62,0,0,0,0,62
2024-10-08,8éû,330,87,243,243,0,55,32,0,0,0,0,330,87,243,243,0,55,32,0,0,0,0,330
2024-10-08,8éûîº,122,122,0,0,0,55,67,0,0,0,0,122,122,0,0,0,55,67,0,0,0,0,122
2024-10-08,9éû,129,129,0,0,0,97,32,0,0,0,0,129,129,0,0,0,97,32,0,0,0,0,129
2024-10-08,9éûîº,74,74,0,0,0,42,32,0,0,0,0,74,74,0,0,0,42,32,0,0,0,0,74
2024-10-08,10éû,42,42,0,0,0,42,0,0,0,0,0,42,42,0,0,0,42,0,0,0,0,0,42
2024-10-08,10éûîº,42,42,0,0,0,42,0,0,0,0,0,42,42,0,0,0,42,0,0,0,0,0,42
2024-10-08,11éû,108,108,0,0,0,108,0,0,0,0,0,108,108,0,0,0,108,0,0,0,0,0,108
2024-10-08,11éûîº,137,137,0,0,0,108,29,0,0,0,29,108,137,0,0,0,108,29,0,0,0,29,108
2024-10-08,12éû,137,137,0,0,0,108,29,0,0,0,29,108,137,0,0,0,108,29,0,0,0,29,108
2024-10-08,12éûîº,108,108,0,0,0,108,0,0,0,0,0,108,108,0,0,0,108,0,0,0,0,0,108
2024-10-08,13éû,108,108,0,0,0,108,0,0,0,0,0,108,108,0,0,0,108,0,0,0,0,0,108
2024-10-08,13éûîº,128,128,0,0,0,108,20,0,0,0,20,108,128,0,0,0,108,20,0,0,0,20,108
2024-10-08,14éû,128,128,0,0,0,108,20,0,0,0,20,108,128,0,0,0,108,20,0,0,0,20,108
2024-10-08,14éûîº,108,108,0,0,0,108,0,0,0,0,0,108,108,0,0,0,108,0,0,0,0,0,108
2024-10-08,15éû,65,65,0,0,0,65,0,0,0,0,0,65,65,0,0,0,65,0,0,0,0,0,65
2024-10-08,15éûîº,105,105,0,0,0,65,0,39,0,0,0,105,105,0,0,0,65,0,39,0,0,0,105
2024-10-08,16éû,105,105,0,0,0,65,0,39,0,0,0,105,105,0,0,0,65,0,39,0,0,0,105
2024-10-08,16éûîº,105,105,0,0,0,65,0,39,0,0,0,105,105,0,0,0,65,0,39,0,0,0,105
2024-10-08,17éû,168,105,63,0,0,129,0,39,0,0,0,168,105,63,0,0,129,0,39,0,0,0,168
2024-10-08,17éûîº,381,318,63,142,0,129,34,75,0,0,36,345,318,63,142,0,129,34,75,0,0,36,345
2024-10-08,18éû,176,176,0,0,0,65,34,75,0,0,36,139,176,0,0,0,65,34,75,0,0,36,139
2024-10-08,18éûîº,39,39,0,0,0,0,0,39,0,0,0,39,39,0,0,0,0,0,39,0,0,0,39
2024-10-08,19éû,39,39,0,0,0,0,0,39,0,0,0,39,39,0,0,0,0,0,39,0,0,0,39
2024-10-08,19éûîº,39,39,0,0,0,0,0,39,0,0,0,39,39,0,0,0,0,0,39,0,0,0,39
2024-10-08,20éû,39,39,0,0,0,0,0,39,0,0,0,39,39,0,0,0,0,0,39,0,0,0,39
2024-10-08,20éûîº,96,96,0,0,57,0,0,39,0,0,57,39,96,0,0,57,0,0,39,0,0,57,39
2024-10-08,21éû,87,87,0,0,57,0,30,0,0,0,57,30,87,0,0,57,0,30,0,0,0,57,30
2024-10-08,21éûîº,56,56,0,0,0,0,56,0,0,0,0,56,56,0,0,0,0,56,0,0,0,0,56
2024-10-08,22éû,26,26,0,0,0,0,26,0,0,0,0,26,26,0,0,0,0,26,0,0,0,0,26
2024-10-08,22éûîº,58,58,0,0,0,0,58,0,0,0,0,58,58,0,0,0,0,58,0,0,0,0,58
2024-10-08,23éû,26,26,0,0,0,0,26,0,0,0,0,26,26,0,0,0,0,26,0,0,0,0,26
2024-10-08,23éûîº,26,26,0,0,0,0,26,0,0,0,0,26,26,0,0,0,0,26,0,0,0,0,26
2024-10-08,24éû,26,26,0,0,0,0,26,0,0,0,0,26,26,0,0,0,0,26,0,0,0,0,26
2024-10-08,24éûîº,26,26,0,0,0,0,26,0,0,0,0,26,26,0,0,0,0,26,0,0,0,0,26
2024-10-08,25éû,26,26,0,0,0,0,26,0,0,0,0,26,26,0,0,0,0,26,0,0,0,0,26
2024-10-08,25éûîº,26,26,0,0,0,0,26,0,0,0,0,26,26,0,0,0,0,26,0,0,0,0,26
2024-10-08,26éû,26,26,0,0,0,0,26,0,0,0,0,26,26,0,0,0,0,26,0,0,0,0,26
2024-10-08,26éûîº,26,26,0,0,0,0,26,0,0,0,0,26,26,0,0,0,0,26,0,0,0,0,26
2024-10-08,27éû,26,26,0,0,0,0,26,0,0,0,0,26,26,0,0,0,0,26,0,0,0,0,26
2024-10-08,27éûîº,26,26,0,0,0,0,26,0,0,0,0,26,26,0,0,0,0,26,0,0,0,0,26
2024-10-08,28éû,26,26,0,0,0,0,26,0,0,0,0,26,26,0,0,0,0,26,0,0,0,0,26
2024-10-08,28éûîº,26,26,0,0,0,0,26,0,0,0,0,26,26,0,0,0,0,26,0,0,0,0,26
2024-10-09,5éû,0,0,0,0,0,0,0,0,0,0,0,0,0,0,0,0,0,0,0,0,0,0,0
2024-10-09,5éûîº,32,32,0,0,0,0,32,0,0,0,0,32,32,0,0,0,0,32,0,0,0,0,32
2024-10-09,6éû,108,55,53,0,0,53,55,0,0,0,23,85,55,53,0,0,53,55,0,0,0,23,85
2024-10-09,6éûîº,103,103,0,0,0,47,55,0,0,0,23,79,103,0,0,0,47,55,0,0,0,23,79
2024-10-09,7éû,116,116,0,0,0,60,55,0,0,0,23,92,116,0,0,0,60,55,0,0,0,23,92
2024-10-09,7éûîº,267,267,0,0,66,109,53,39,0,0,48,218,267,0,0,66,109,53,39,0,0,48,218
2024-10-09,8éû,317,262,55,0,112,97,53,0,55,0,104,213,262,55,0,112,97,53,0,55,0,104,213
2024-10-09,8éûîº,433,410,23,135,66,145,56,31,0,0,80,354,410,23,135,66,145,56,31,0,0,80,354
2024-10-09,9éû,538,303,235,212,127,143,56,0,0,0,307,231,303,235,212,127,143,56,0,0,0,307,231
2024-10-09,9éûîº,638,426,212,308,195,48,53,31,0,0,260,377,426,212,308,195,48,53,31,0,0,260,377
2024-10-09,10éû,523,311,212,308,134,48,0,31,0,0,260,262,311,212,308,134,48,0,31,0,0,260,262
2024-10-09,10éûîº,423,211,212,308,66,48,0,0,0,0,260,162,211,212,308,66,48,0,0,0,0,260,162
2024-10-09,11éû,530,211,319,212,221,97,0,0,0,0,260,270,211,319,212,221,97,0,0,0,0,260,270
2024-10-09,11éûîº,628,309,319,212,173,243,0,0,0,0,260,368,309,319,212,173,243,0,0,0,0,260,368
2024-10-09,12éû,598,279,319,212,173,181,0,31,0,0,243,355,279,319,212,173,181,0,31,0,0,243,355
2024-10-09,12éûîº,730,420,310,212,127,359,0,31,0,0,341,388,420,310,212,127,359,0,31,0,0,341,388
2024-10-09,13éû,517,207,310,212,66,207,0,31,0,0,341,175,207,310,212,66,207,0,31,0,0,341,175
2024-10-09,13éûîº,541,231,310,212,66,202,29,31,0,0,371,169,231,310,212,66,202,29,31,0,0,371,169
2024-10-09,14éû,518,306,212,212,66,159,49,31,0,0,273,245,306,212,212,66,159,49,31,0,0,273,245
2024-10-09,14éûîº,715,438,277,212,122,234,115,31,0,0,273,442,438,277,212,122,234,115,31,0,0,273,442
2024-10-09,15éû,784,457,327,333,66,255,69,60,0,0,302,481,457,327,333,66,255,69,60,0,0,302,481
2024-10-09,15éûîº,448,448,0,121,66,112,59,90,0,0,61,387,448,0,121,66,112,59,90,0,0,61,387
2024-10-09,16éû,407,407,0,121,66,112,51,57,0,0,61,346,407,0,121,66,112,51,57,0,0,61,346
2024-10-09,16éûîº,382,382,0,0,66,112,123,57,23,0,84,298,382,0,0,66,112,123,57,23,0,84,298
2024-10-09,17éû,344,344,0,0,66,112,56,57,52,0,54,289,344,0,0,66,112,56,57,52,0,54,289
2024-10-09,17éûîº,398,299,99,0,130,112,68,57,28,0,31,366,299,99,0,130,112,68,57,28,0,31,366
2024-10-09,18éû,283,163,120,0,130,65,0,31,55,0,31,251,163,120,0,130,65,0,31,55,0,31,251
2024-10-09,18éûîº,381,261,120,0,225,100,0,0,55,0,94,286,261,120,0,225,100,0,0,55,0,94,286
2024-10-09,19éû,259,195,64,0,225,34,0,0,0,0,94,165,195,64,0,225,34,0,0,0,0,94,165
2024-10-09,19éûîº,164,100,64,0,130,34,0,0,0,0,0,165,100,64,0,130,34,0,0,0,0,0,165
2024-10-09,20éû,196,132,64,0,130,34,0,0,31,0,31,165,132,64,0,130,34,0,0,31,0,31,165
2024-10-09,20éûîº,156,92,64,0,130,0,26,0,0,0,0,157,92,64,0,130,0,26,0,0,0,0,157
2024-10-09,21éû,90,26,64,0,64,0,26,0,0,0,0,91,26,64,0,64,0,26,0,0,0,0,91
2024-10-09,21éûîº,125,61,64,0,64,34,26,0,0,0,0,126,61,64,0,64,34,26,0,0,0,0,126
2024-10-09,22éû,64,0,64,0,64,0,0,0,0,0,0,64,0,64,0,64,0,0,0,0,0,0,64
2024-10-09,22éûîº,64,0,64,0,64,0,0,0,0,0,0,64,0,64,0,64,0,0,0,0,0,0,64
2024-10-09,23éû,64,0,64,0,64,0,0,0,0,0,0,64,0,64,0,64,0,0,0,0,0,0,64
2024-10-09,23éûîº,153,89,64,0,118,36,0,0,0,0,0,154,89,64,0,118,36,0,0,0,0,0,154
2024-10-09,24éû,89,89,0,0,53,36,0,0,0,0,0,89,89,0,0,53,36,0,0,0,0,0,89
2024-10-09,24éûîº,89,89,0,0,53,36,0,0,0,0,0,89,89,0,0,53,36,0,0,0,0,0,89
2024-10-09,25éû,89,89,0,0,53,36,0,0,0,0,0,89,89,0,0,53,36,0,0,0,0,0,89
2024-10-09,25éûîº,89,89,0,0,53,36,0,0,0,0,0,89,89,0,0,53,36,0,0,0,0,0,89
2024-10-09,26éû,89,89,0,0,53,36,0,0,0,0,0,89,89,0,0,53,36,0,0,0,0,0,89
2024-10-09,26éûîº,89,89,0,0,53,36,0,0,0,0,0,89,89,0,0,53,36,0,0,0,0,0,89
2024-10-09,27éû,89,89,0,0,53,36,0,0,0,0,0,89,89,0,0,53,36,0,0,0,0,0,89
2024-10-09,27éûîº,89,89,0,0,53,36,0,0,0,0,0,89,89,0,0,53,36,0,0,0,0,0,89
2024-10-09,28éû,126,126,0,0,53,73,0,0,0,0,0,126,126,0,0,53,73,0,0,0,0,0,126
2024-10-09,28éûîº,126,126,0,0,53,73,0,0,0,0,0,126,126,0,0,53,73,0,0,0,0,0,126
2024-10-10,5éû,59,59,0,0,0,36,0,22,0,0,0,59,59,0,0,0,36,0,22,0,0,0,59
2024-10-10,5éûîº,99,68,31,0,0,36,31,31,0,0,31,68,68,31,0,0,36,31,31,0,0,31,68
2024-10-10,6éû,67,36,31,0,0,36,0,31,0,0,31,36,36,31,0,0,36,0,31,0,0,31,36
2024-10-10,6éûîº,152,121,31,0,0,88,32,31,0,0,31,121,121,31,0,0,88,32,31,0,0,31,121
2024-10-10,7éû,145,68,77,0,0,36,78,31,0,0,77,68,68,77,0,0,36,78,31,0,0,77,68
2024-10-10,7éûîº,234,84,150,0,73,52,78,31,0,0,77,157,84,150,0,73,52,78,31,0,0,77,157
2024-10-10,8éû,246,215,31,102,0,52,32,31,28,0,31,215,215,31,102,0,52,32,31,28,0,31,215
2024-10-10,8éûîº,277,246,31,126,59,0,32,31,28,0,31,246,246,31,126,59,0,32,31,28,0,31,246
2024-10-10,9éû,333,302,31,241,0,0,32,31,28,0,31,302,302,31,241,0,0,32,31,28,0,31,302
2024-10-10,9éûîº,276,245,31,115,0,40,60,31,28,0,31,245,245,31,115,0,40,60,31,28,0,31,245
2024-10-10,10éû,215,184,31,115,0,40,0,31,28,0,31,184,184,31,115,0,40,0,31,28,0,31,184
2024-10-10,10éûîº,59,28,31,0,0,0,0,31,28,0,31,28,28,31,0,0,0,0,31,28,0,31,28
2024-10-10,11éû,236,63,173,0,0,0,52,94,89,0,31,205,63,173,0,0,0,52,94,89,0,31,205
2024-10-10,11éûîº,384,211,173,0,47,46,106,94,89,0,31,353,211,173,0,47,46,106,94,89,0,31,353
2024-10-10,12éû,275,191,84,0,0,46,134,94,0,0,54,221,191,84,0,0,46,134,94,0,0,54,221
2024-10-10,12éûîº,256,131,125,0,0,46,178,31,0,0,31,225,131,125,0,0,46,178,31,0,0,31,225
2024-10-10,13éû,297,203,94,126,0,46,124,0,0,0,0,297,203,94,126,0,46,124,0,0,0,0,297
2024-10-10,13éûîº,187,146,41,0,0,46,102,39,0,0,0,187,146,41,0,0,46,102,39,0,0,0,187
2024-10-10,14éû,342,311,31,225,0,46,0,70,0,0,31,311,311,31,225,0,46,0,70,0,0,31,311
2024-10-10,14éûîº,141,141,0,0,0,46,0,95,0,0,0,141,141,0,0,0,46,0,95,0,0,0,141
2024-10-10,15éû,298,85,213,0,178,46,0,74,0,0,178,120,85,213,0,178,46,0,74,0,0,178,120
2024-10-10,15éûîº,327,114,213,0,178,114,0,35,0,0,178,149,114,213,0,178,114,0,35,0,0,178,149
2024-10-10,16éû,571,359,212,130,178,175,63,24,0,0,178,393,359,212,130,178,175,63,24,0,0,178,393
2024-10-10,16éûîº,387,46,341,129,178,46,33,0,0,0,178,209,46,341,129,178,46,33,0,0,0,178,209
2024-10-10,17éû,230,76,154,129,0,46,56,0,0,0,0,231,76,154,129,0,46,56,0,0,0,0,231
2024-10-10,17éûîº,186,57,129,129,0,0,57,0,0,0,0,186,57,129,129,0,0,57,0,0,0,0,186
2024-10-10,18éû,525,121,404,317,0,181,26,0,0,0,0,525,121,404,317,0,181,26,0,0,0,0,525
2024-10-10,18éûîº,502,109,393,317,0,159,26,0,0,0,0,503,109,393,317,0,159,26,0,0,0,0,503
2024-10-10,19éû,331,202,129,129,66,82,26,25,0,0,25,305,202,129,129,66,82,26,25,0,0,25,305
2024-10-10,19éûîº,331,202,129,129,66,82,26,25,0,0,25,305,202,129,129,66,82,26,25,0,0,25,305
2024-10-10,20éû,228,99,129,129,0,46,26,25,0,0,25,202,99,129,129,0,46,26,25,0,0,25,202
2024-10-10,20éûîº,26,26,0,0,0,0,26,0,0,0,0,26,26,0,0,0,0,26,0,0,0,0,26
2024-10-10,21éû,26,26,0,0,0,0,26,0,0,0,0,26,26,0,0,0,0,26,0,0,0,0,26
2024-10-10,21éûîº,26,26,0,0,0,0,26,0,0,0,0,26,26,0,0,0,0,26,0,0,0,0,26
2024-10-10,22éû,175,92,83,65,83,0,26,0,0,0,0,176,92,83,65,83,0,26,0,0,0,0,176
2024-10-10,22éûîº,148,65,83,65,83,0,0,0,0,0,0,149,65,83,65,83,0,0,0,0,0,0,149
2024-10-10,23éû,65,65,0,65,0,0,0,0,0,0,0,65,65,0,65,0,0,0,0,0,0,0,65
2024-10-10,23éûîº,101,65,36,65,0,0,36,0,0,0,0,102,65,36,65,0,0,36,0,0,0,0,102
2024-10-10,24éû,334,108,226,256,0,42,36,0,0,0,0,335,108,226,256,0,42,36,0,0,0,0,335
2024-10-10,24éûîº,334,108,226,256,0,42,36,0,0,0,0,335,108,226,256,0,42,36,0,0,0,0,335
2024-10-10,25éû,291,65,226,256,0,0,36,0,0,0,0,292,65,226,256,0,0,36,0,0,0,0,292
2024-10-10,25éûîº,226,0,226,190,0,0,36,0,0,0,0,226,0,226,190,0,0,36,0,0,0,0,226
2024-10-10,26éû,190,0,190,190,0,0,0,0,0,0,0,190,0,190,190,0,0,0,0,0,0,0,190
2024-10-10,26éûîº,190,0,190,190,0,0,0,0,0,0,0,190,0,190,190,0,0,0,0,0,0,0,190
2024-10-10,27éû,190,0,190,190,0,0,0,0,0,0,0,190,0,190,190,0,0,0,0,0,0,0,190
2024-10-10,27éûîº,190,0,190,190,0,0,0,0,0,0,0,190,0,190,190,0,0,0,0,0,0,0,190
2024-10-10,28éû,190,0,190,190,0,0,0,0,0,0,0,190,0,190,190,0,0,0,0,0,0,0,190
2024-10-10,28éûîº,190,0,190,190,0,0,0,0,0,0,0,190,0,190,190,0,0,0,0,0,0,0,190
2024-10-11,5éû,371,93,278,190,0,71,21,0,88,0,0,371,93,278,190,0,71,21,0,88,0,0,371
2024-10-11,5éûîº,261,71,190,190,0,71,0,0,0,0,0,262,71,190,190,0,71,0,0,0,0,0,262
2024-10-11,6éû,71,71,0,0,0,71,0,0,0,0,0,71,71,0,0,0,71,0,0,0,0,0,71
2024-10-11,6éûîº,185,185,0,114,0,71,0,0,0,0,0,185,185,0,114,0,71,0,0,0,0,0,185
2024-10-11,7éû,407,217,190,304,0,71,32,0,0,0,0,408,217,190,304,0,71,32,0,0,0,0,408
2024-10-11,7éûîº,357,134,223,190,0,71,95,0,0,0,32,324,134,223,190,0,71,95,0,0,0,32,324
2024-10-11,8éû,573,103,470,400,0,71,101,0,0,0,69,504,103,470,400,0,71,101,0,0,0,69,504
2024-10-11,8éûîº,536,103,433,400,0,71,64,0,0,0,32,504,103,433,400,0,71,64,0,0,0,32,504
2024-10-11,9éû,164,132,32,0,0,71,64,28,0,0,32,132,132,32,0,0,71,64,28,0,0,32,132
2024-10-11,9éûîº,103,71,32,0,0,71,32,0,0,0,32,71,71,32,0,0,71,32,0,0,0,32,71
2024-10-11,10éû,69,37,32,0,0,37,32,0,0,0,32,37,37,32,0,0,37,32,0,0,0,32,37
2024-10-11,10éûîº,119,87,32,0,0,87,32,0,0,0,32,87,87,32,0,0,87,32,0,0,0,32,87
2024-10-11,11éû,261,229,32,0,0,111,112,0,38,0,32,229,229,32,0,0,111,112,0,38,0,32,229
2024-10-11,11éûîº,260,228,32,0,49,60,112,0,38,0,32,228,228,32,0,49,60,112,0,38,0,32,228
2024-10-11,12éû,355,323,32,0,49,161,144,0,0,0,110,246,323,32,0,49,161,144,0,0,0,110,246
2024-10-11,12éûîº,271,239,32,0,49,161,60,0,0,0,78,194,239,32,0,49,161,60,0,0,0,78,194
2024-10-11,13éû,172,150,22,0,49,101,0,22,0,0,45,128,150,22,0,49,101,0,22,0,0,45,128
2024-10-11,13éûîº,182,160,22,0,104,55,0,22,0,0,0,183,160,22,0,104,55,0,22,0,0,0,183
2024-10-11,14éû,183,183,0,0,104,55,0,23,0,0,0,183,183,0,0,104,55,0,23,0,0,0,183
2024-10-11,14éûîº,111,111,0,0,0,55,0,23,31,0,0,111,111,0,0,0,55,0,23,31,0,0,111
2024-10-11,15éû,131,131,0,0,0,99,0,0,31,0,0,131,131,0,0,0,99,0,0,31,0,0,131
2024-10-11,15éûîº,270,270,0,0,63,99,38,0,69,0,0,270,270,0,0,63,99,38,0,69,0,0,270
2024-10-11,16éû,262,262,0,0,63,99,30,0,69,0,0,262,262,0,0,63,99,30,0,69,0,0,262
2024-10-11,16éûîº,65,65,0,0,0,0,0,28,37,0,0,65,65,0,0,0,0,0,28,37,0,0,65
2024-10-11,17éû,67,37,30,0,0,0,0,30,37,0,0,67,37,30,0,0,0,0,30,37,0,0,67
2024-10-11,17éûîº,303,83,220,190,0,46,0,30,37,0,0,303,83,220,190,0,46,0,30,37,0,0,303
2024-10-11,18éû,488,268,220,329,0,91,0,30,37,0,0,488,268,220,329,0,91,0,30,37,0,0,488
2024-10-11,18éûîº,442,222,220,329,0,46,0,30,37,0,0,443,222,220,329,0,46,0,30,37,0,0,443
2024-10-11,19éû,634,176,458,566,0,0,0,30,37,0,0,634,176,458,566,0,0,0,30,37,0,0,634
2024-10-11,19éûîº,741,283,458,566,79,0,0,30,65,79,0,662,283,458,566,79,0,0,30,65,79,0,662
2024-10-11,20éû,797,339,458,566,79,83,0,30,37,79,0,717,339,458,566,79,83,0,30,37,79,0,717
2024-10-11,20éûîº,619,315,304,329,83,83,54,69,0,0,0,620,315,304,329,83,83,54,69,0,0,0,620
2024-10-11,21éû,701,350,351,329,83,165,54,69,0,0,0,702,350,351,329,83,165,54,69,0,0,0,702
2024-10-11,21éûîº,884,341,543,520,83,165,84,30,0,0,0,885,341,543,520,83,165,84,30,0,0,0,885
2024-10-11,22éû,896,367,529,520,83,118,117,55,0,0,0,896,367,529,520,83,118,117,55,0,0,0,896
2024-10-11,22éûîº,614,169,445,381,0,118,59,55,0,0,0,615,169,445,381,0,118,59,55,0,0,0,615
2024-10-11,23éû,563,118,445,381,0,118,33,30,0,0,0,563,118,445,381,0,118,33,30,0,0,0,563
2024-10-11,23éûîº,563,118,445,381,0,118,33,30,0,0,0,563,118,445,381,0,118,33,30,0,0,0,563
2024-10-11,24éû,533,118,415,381,0,118,33,0,0,0,0,533,118,415,381,0,118,33,0,0,0,0,533
2024-10-11,24éûîº,499,118,381,381,0,118,0,0,0,0,0,499,118,381,381,0,118,0,0,0,0,0,499
2024-10-11,25éû,499,118,381,381,0,118,0,0,0,0,0,499,118,381,381,0,118,0,0,0,0,0,499
2024-10-11,25éûîº,499,118,381,381,0,118,0,0,0,0,0,499,118,381,381,0,118,0,0,0,0,0,499
2024-10-11,26éû,261,71,190,190,0,71,0,0,0,0,0,262,71,190,190,0,71,0,0,0,0,0,262
2024-10-11,26éûîº,284,94,190,190,0,71,0,22,0,0,0,284,94,190,190,0,71,0,22,0,0,0,284
2024-10-11,27éû,261,71,190,190,0,71,0,0,0,0,0,262,71,190,190,0,71,0,0,0,0,0,262
2024-10-11,27éûîº,261,71,190,190,0,71,0,0,0,0,0,262,71,190,190,0,71,0,0,0,0,0,262
2024-10-11,28éû,261,71,190,190,0,71,0,0,0,0,0,262,71,190,190,0,71,0,0,0,0,0,262
2024-10-11,28éûîº,261,71,190,190,0,71,0,0,0,0,0,262,71,190,190,0,71,0,0,0,0,0,262
2024-10-12,5éû,0,0,0,0,0,0,0,0,0,0,0,0,0,0,0,0,0,0,0,0,0,0,0
2024-10-12,5éûîº,191,0,191,191,0,0,0,0,0,0,0,191,0,191,191,0,0,0,0,0,0,0,191
2024-10-12,6éû,233,42,191,191,0,42,0,0,0,0,0,233,42,191,191,0,42,0,0,0,0,0,233
2024-10-12,6éûîº,233,42,191,191,0,42,0,0,0,0,0,233,42,191,191,0,42,0,0,0,0,0,233
2024-10-12,7éû,281,90,191,191,0,90,0,0,0,0,0,281,90,191,191,0,90,0,0,0,0,0,281
2024-10-12,7éûîº,259,68,191,191,0,42,0,25,0,0,0,259,68,191,191,0,42,0,25,0,0,0,259
2024-10-12,8éû,297,82,215,191,0,42,40,24,0,0,0,298,82,215,191,0,42,40,24,0,0,0,298
2024-10-12,8éûîº,246,0,246,191,0,0,0,55,0,0,0,246,0,246,191,0,0,0,55,0,0,0,246
2024-10-12,9éû,55,0,55,0,0,0,0,55,0,0,0,55,0,55,0,0,0,0,55,0,0,0,55
2024-10-12,9éûîº,24,0,24,0,0,0,0,24,0,0,0,24,0,24,0,0,0,0,24,0,0,0,24
2024-10-12,10éû,113,89,24,0,0,33,55,24,0,0,0,113,89,24,0,0,33,55,24,0,0,0,113
2024-10-12,10éûîº,191,130,61,0,0,74,55,61,0,0,0,191,130,61,0,0,74,55,61,0,0,0,191
2024-10-12,11éû,101,40,61,0,0,40,0,61,0,0,0,102,40,61,0,0,40,0,61,0,0,0,102
2024-10-12,11éûîº,376,127,249,212,0,127,0,37,0,0,212,164,127,249,212,0,127,0,37,0,0,212,164
2024-10-12,12éû,293,44,249,212,0,44,0,37,0,0,212,81,44,249,212,0,44,0,37,0,0,212,81
2024-10-12,12éûîº,363,86,277,212,65,86,0,0,0,0,212,152,86,277,212,65,86,0,0,0,0,212,152
2024-10-12,13éû,319,42,277,212,65,42,0,0,0,0,212,107,42,277,212,65,42,0,0,0,0,212,107
2024-10-12,13éûîº,236,24,212,212,0,0,24,0,0,0,212,24,24,212,212,0,0,24,0,0,0,212,24
2024-10-12,14éû,386,174,212,336,0,50,0,0,0,0,212,174,174,212,336,0,50,0,0,0,0,212,174
2024-10-12,14éûîº,333,121,212,212,45,50,26,0,0,0,212,121,121,212,212,45,50,26,0,0,0,212,121
2024-10-12,15éû,295,83,212,212,0,83,0,0,0,0,212,83,83,212,212,0,83,0,0,0,0,212,83
2024-10-12,15éûîº,252,40,212,212,0,40,0,0,0,0,212,40,40,212,212,0,40,0,0,0,0,212,40
2024-10-12,16éû,261,261,0,144,55,40,0,21,0,0,0,261,261,0,144,55,40,0,21,0,0,0,261
2024-10-12,16éûîº,212,212,0,144,0,0,20,47,0,0,0,212,212,0,144,0,0,20,47,0,0,0,212
2024-10-12,17éû,223,42,181,181,0,0,20,21,0,0,0,224,42,181,181,0,0,20,21,0,0,0,224
2024-10-12,17éûîº,171,140,31,0,90,0,20,60,0,0,0,171,140,31,0,90,0,20,60,0,0,0,171
2024-10-12,18éû,232,201,31,0,152,0,19,60,0,0,0,232,201,31,0,152,0,19,60,0,0,0,232
2024-10-12,18éûîº,152,121,31,0,61,0,30,60,0,0,0,152,121,31,0,61,0,30,60,0,0,0,152
2024-10-12,19éû,102,102,0,0,0,73,0,28,0,0,0,102,102,0,0,0,73,0,28,0,0,0,102
2024-10-12,19éûîº,136,102,34,0,0,73,34,28,0,0,0,136,102,34,0,0,73,34,28,0,0,0,136
2024-10-12,20éû,166,102,64,0,0,73,34,59,0,0,0,166,102,64,0,0,73,34,59,0,0,0,166
2024-10-12,20éûîº,140,73,67,0,0,73,0,30,37,0,0,140,73,67,0,0,73,0,30,37,0,0,140
2024-10-12,21éû,188,158,30,0,59,73,25,30,0,0,0,188,158,30,0,59,73,25,30,0,0,0,188
2024-10-12,21éûîº,266,158,108,0,59,120,25,61,0,0,0,266,158,108,0,59,120,25,61,0,0,0,266
2024-10-12,22éû,219,158,61,0,59,73,25,61,0,0,0,219,158,61,0,59,73,25,61,0,0,0,219
2024-10-12,22éûîº,280,158,122,0,120,73,25,61,0,0,0,281,158,122,0,120,73,25,61,0,0,0,281
2024-10-12,23éû,317,158,159,0,120,73,62,61,0,0,0,317,158,159,0,120,73,62,61,0,0,0,317
2024-10-12,23éûîº,280,158,122,0,120,73,25,61,0,0,0,281,158,122,0,120,73,25,61,0,0,0,281
2024-10-12,24éû,280,158,122,0,120,73,25,61,0,0,0,281,158,122,0,120,73,25,61,0,0,0,281
2024-10-12,24éûîº,280,158,122,0,120,73,25,61,0,0,0,281,158,122,0,120,73,25,61,0,0,0,281
2024-10-12,25éû,280,158,122,0,120,73,25,61,0,0,0,281,158,122,0,120,73,25,61,0,0,0,281
2024-10-12,25éûîº,303,181,122,0,120,73,25,85,0,0,0,304,181,122,0,120,73,25,85,0,0,0,304
2024-10-12,26éû,280,158,122,0,120,73,25,61,0,0,0,281,158,122,0,120,73,25,61,0,0,0,281
2024-10-12,26éûîº,254,132,122,0,120,73,0,61,0,0,0,255,132,122,0,120,73,0,61,0,0,0,255
2024-10-12,27éû,254,132,122,0,120,73,0,61,0,0,0,255,132,122,0,120,73,0,61,0,0,0,255
2024-10-12,27éûîº,378,256,122,124,120,73,0,61,0,0,0,379,256,122,124,120,73,0,61,0,0,0,379
2024-10-12,28éû,342,220,122,124,120,37,0,61,0,0,0,343,220,122,124,120,37,0,61,0,0,0,343
2024-10-12,28éûîº,342,220,122,124,120,37,0,61,0,0,0,343,220,122,124,120,37,0,61,0,0,0,343
2024-10-13,5éû,0,0,0,0,0,0,0,0,0,0,0,0,0,0,0,0,0,0,0,0,0,0,0
2024-10-13,5éûîº,124,124,0,124,0,0,0,0,0,0,0,124,124,0,124,0,0,0,0,0,0,0,124
2024-10-13,6éû,124,124,0,124,0,0,0,0,0,0,0,124,124,0,124,0,0,0,0,0,0,0,124
2024-10-13,6éûîº,224,224,0,124,0,100,0,0,0,0,0,224,224,0,124,0,100,0,0,0,0,0,224
2024-10-13,7éû,86,86,0,0,0,86,0,0,0,0,0,86,86,0,0,0,86,0,0,0,0,0,86
2024-10-13,7éûîº,44,44,0,0,0,44,0,0,0,0,0,44,44,0,0,0,44,0,0,0,0,0,44
2024-10-13,8éû,96,96,0,0,51,44,0,0,0,0,0,96,96,0,0,51,44,0,0,0,0,0,96
2024-10-13,8éûîº,96,96,0,0,51,44,0,0,0,0,0,96,96,0,0,51,44,0,0,0,0,0,96
2024-10-13,9éû,175,175,0,0,0,99,51,24,0,0,0,175,175,0,0,0,99,51,24,0,0,0,175
2024-10-13,9éûîº,614,402,212,212,148,99,131,23,0,0,212,402,402,212,212,148,99,131,23,0,0,212,402
2024-10-13,10éû,870,621,249,212,270,194,143,49,0,0,212,658,621,249,212,270,194,143,49,0,0,212,658
2024-10-13,10éûîº,1221,888,333,339,444,204,143,27,63,0,212,1010,888,333,339,444,204,143,27,63,0,212,1010
2024-10-13,11éû,1279,879,400,339,287,237,217,168,28,0,212,1067,879,400,339,287,237,217,168,28,0,212,1067
2024-10-13,11éûîº,1682,1081,601,638,351,443,138,77,32,0,212,1470,1081,601,638,351,443,138,77,32,0,212,1470
2024-10-13,12éû,1978,852,1126,1102,146,496,147,57,27,0,212,1766,852,1126,1102,146,496,147,57,27,0,212,1766
2024-10-13,12éûîº,1897,662,1235,987,203,403,115,122,64,0,212,1685,662,1235,987,203,403,115,122,64,0,212,1685
2024-10-13,13éû,1307,847,460,212,401,389,167,65,73,0,212,1095,847,460,212,401,389,167,65,73,0,212,1095
2024-10-13,13éûîº,1359,700,659,396,287,235,276,28,136,0,212,1148,700,659,396,287,235,276,28,136,0,212,1148
2024-10-13,14éû,1020,561,459,212,257,440,112,0,0,0,212,809,561,459,212,257,440,112,0,0,0,212,809
2024-10-13,14éûîº,779,471,308,212,71,340,122,32,0,0,212,567,471,308,212,71,340,122,32,0,0,212,567
2024-10-13,15éû,1254,572,682,633,52,397,145,25,0,0,212,1042,572,682,633,52,397,145,25,0,0,212,1042
2024-10-13,15éûîº,704,309,395,212,140,276,76,0,0,0,212,492,309,395,212,140,276,76,0,0,0,212,492
2024-10-13,16éû,1086,695,391,334,447,225,52,27,0,0,212,875,695,391,334,447,225,52,27,0,0,212,875
2024-10-13,16éûîº,642,556,86,122,181,217,27,27,66,0,0,643,556,86,122,181,217,27,27,66,0,0,643
2024-10-13,17éû,398,372,26,122,122,99,54,0,0,0,0,398,372,26,122,122,99,54,0,0,0,0,398
2024-10-13,17éûîº,102,76,26,0,0,45,26,30,0,0,0,102,76,26,0,0,45,26,30,0,0,0,102
2024-10-13,18éû,102,76,26,0,0,45,26,30,0,0,0,102,76,26,0,0,45,26,30,0,0,0,102
2024-10-13,18éûîº,129,129,0,0,52,45,0,30,0,0,0,129,129,0,0,52,45,0,30,0,0,0,129
2024-10-13,19éû,128,76,52,0,0,98,0,30,0,0,0,129,76,52,0,0,98,0,30,0,0,0,129
2024-10-13,19éûîº,128,76,52,0,0,98,0,30,0,0,0,129,76,52,0,0,98,0,30,0,0,0,129
2024-10-13,20éû,128,76,52,0,0,98,0,30,0,0,0,129,76,52,0,0,98,0,30,0,0,0,129
2024-10-13,20éûîº,353,301,52,225,0,98,0,30,0,0,0,354,301,52,225,0,98,0,30,0,0,0,354
2024-10-13,21éû,128,76,52,0,0,98,0,30,0,0,0,129,76,52,0,0,98,0,30,0,0,0,129
2024-10-13,21éûîº,128,76,52,0,0,98,0,30,0,0,0,129,76,52,0,0,98,0,30,0,0,0,129
2024-10-13,22éû,128,76,52,0,0,98,0,30,0,0,0,129,76,52,0,0,98,0,30,0,0,0,129
2024-10-13,22éûîº,128,76,52,0,0,98,0,30,0,0,0,129,76,52,0,0,98,0,30,0,0,0,129
2024-10-13,23éû,154,102,52,0,0,98,30,26,0,0,0,154,102,52,0,0,98,30,26,0,0,0,154
2024-10-13,23éûîº,123,71,52,0,0,98,0,26,0,0,0,124,71,52,0,0,98,0,26,0,0,0,124
2024-10-13,24éû,52,0,52,0,0,52,0,0,0,0,0,52,0,52,0,0,52,0,0,0,0,0,52
2024-10-13,24éûîº,70,18,52,0,0,52,18,0,0,0,0,71,18,52,0,0,52,18,0,0,0,0,71
2024-10-13,25éû,52,0,52,0,0,52,0,0,0,0,0,52,0,52,0,0,52,0,0,0,0,0,52
2024-10-13,25éûîº,52,0,52,0,0,52,0,0,0,0,0,52,0,52,0,0,52,0,0,0,0,0,52
2024-10-13,26éû,52,0,52,0,0,52,0,0,0,0,0,52,0,52,0,0,52,0,0,0,0,0,52
2024-10-13,26éûîº,52,0,52,0,0,52,0,0,0,0,0,52,0,52,0,0,52,0,0,0,0,0,52
2024-10-13,27éû,52,0,52,0,0,52,0,0,0,0,0,52,0,52,0,0,52,0,0,0,0,0,52
2024-10-13,27éûîº,52,0,52,0,0,52,0,0,0,0,0,52,0,52,0,0,52,0,0,0,0,0,52
2024-10-13,28éû,52,0,52,0,0,52,0,0,0,0,0,52,0,52,0,0,52,0,0,0,0,0,52
2024-10-13,28éûîº,52,0,52,0,0,52,0,0,0,0,0,52,0,52,0,0,52,0,0,0,0,0,52
2024-10-14,5éû,92,0,92,0,0,52,0,0,39,0,0,92,0,92,0,0,52,0,0,39,0,0,92
2024-10-14,5éûîº,92,0,92,0,0,52,0,0,39,0,0,92,0,92,0,0,52,0,0,39,0,0,92
2024-10-14,6éû,92,0,92,0,0,52,0,0,39,0,0,92,0,92,0,0,52,0,0,39,0,0,92
2024-10-14,6éûîº,92,0,92,0,0,52,0,0,39,0,0,92,0,92,0,0,52,0,0,39,0,0,92
2024-10-14,7éû,39,0,39,0,0,0,0,0,39,0,0,39,0,39,0,0,0,0,0,39,0,0,39
2024-10-14,7éûîº,130,91,39,0,0,91,0,0,39,0,0,130,91,39,0,0,91,0,0,39,0,0,130
2024-10-14,8éû,112,73,39,0,0,47,25,0,39,0,0,113,73,39,0,0,47,25,0,39,0,0,113
2024-10-14,8éûîº,32,32,0,0,0,0,32,0,0,0,0,32,32,0,0,0,0,32,0,0,0,0,32
2024-10-14,9éû,276,64,212,212,0,0,32,32,0,0,212,64,64,212,212,0,0,32,32,0,0,212,64
2024-10-14,9éûîº,415,64,351,212,139,0,32,32,0,0,212,204,64,351,212,139,0,32,32,0,0,212,204
2024-10-14,10éû,370,158,212,212,45,48,32,32,0,0,212,158,158,212,212,45,48,32,32,0,0,212,158
2024-10-14,10éûîº,381,130,251,212,0,137,32,0,0,0,212,169,130,251,212,0,137,32,0,0,0,212,169
2024-10-14,11éû,500,81,419,212,90,141,32,25,0,0,212,289,81,419,212,90,141,32,25,0,0,212,289
2024-10-14,11éûîº,994,364,630,212,90,457,176,25,34,0,212,783,364,630,212,90,457,176,25,34,0,212,783
2024-10-14,12éû,1071,506,565,319,90,416,151,25,68,0,212,859,506,565,319,90,416,151,25,68,0,212,859
2024-10-14,12éûîº,1166,646,520,319,229,310,211,63,33,0,212,955,646,520,319,229,310,211,63,33,0,212,955
2024-10-14,13éû,1108,672,436,314,80,313,276,90,33,0,212,896,672,436,314,80,313,276,90,33,0,212,896
2024-10-14,13éûîº,1225,611,614,314,56,503,268,81,0,0,212,1014,611,614,314,56,503,268,81,0,0,212,1014
2024-10-14,14éû,1121,485,636,212,0,556,236,51,66,0,212,910,485,636,212,0,556,236,51,66,0,212,910
2024-10-14,14éûîº,917,560,357,457,0,252,173,0,33,0,212,705,560,357,457,0,252,173,0,33,0,212,705
2024-10-14,15éû,1118,469,649,503,127,254,177,56,0,0,212,907,469,649,503,127,254,177,56,0,0,212,907
2024-10-14,15éûîº,855,299,556,503,127,97,127,0,0,0,212,643,299,556,503,127,97,127,0,0,0,212,643
2024-10-14,16éû,1023,259,764,503,235,158,62,24,39,0,212,811,259,764,503,235,158,62,24,39,0,212,811
2024-10-14,16éûîº,1092,303,789,503,235,264,0,50,39,0,212,880,303,789,503,235,264,0,50,39,0,212,880
2024-10-14,17éû,836,285,551,291,314,180,0,50,0,0,0,837,285,551,291,314,180,0,50,0,0,0,837
2024-10-14,17éûîº,167,93,74,0,68,74,0,24,0,0,0,167,93,74,0,68,74,0,24,0,0,0,167
2024-10-14,18éû,170,93,77,0,68,0,37,24,39,0,0,170,93,77,0,68,0,37,24,39,0,0,170
2024-10-14,18éûîº,105,68,37,0,68,0,37,0,0,0,0,106,68,37,0,68,0,37,0,0,0,0,106
2024-10-14,19éû,105,68,37,0,68,0,37,0,0,0,0,106,68,37,0,68,0,37,0,0,0,0,106
2024-10-14,19éûîº,105,68,37,0,68,0,37,0,0,0,0,106,68,37,0,68,0,37,0,0,0,0,106
2024-10-14,20éû,105,68,37,0,68,0,37,0,0,0,0,106,68,37,0,68,0,37,0,0,0,0,106
2024-10-14,20éûîº,137,68,69,0,68,0,69,0,0,0,0,137,68,69,0,68,0,69,0,0,0,0,137
2024-10-14,21éû,105,68,37,0,68,0,37,0,0,0,0,106,68,37,0,68,0,37,0,0,0,0,106
2024-10-14,21éûîº,145,68,77,0,68,0,37,0,39,0,0,146,68,77,0,68,0,37,0,39,0,0,146
2024-10-14,22éû,173,96,77,0,68,0,66,0,39,0,0,174,96,77,0,68,0,66,0,39,0,0,174
2024-10-14,22éûîº,126,87,39,0,68,0,19,0,39,0,0,127,87,39,0,68,0,19,0,39,0,0,127
2024-10-14,23éû,282,243,39,243,0,0,0,0,39,0,0,283,243,39,243,0,0,0,0,39,0,0,283
2024-10-14,23éûîº,39,0,39,0,0,0,0,0,39,0,0,39,0,39,0,0,0,0,0,39,0,0,39
2024-10-14,24éû,63,0,63,0,0,0,24,0,39,0,0,63,0,63,0,0,0,24,0,39,0,0,63
2024-10-14,24éûîº,63,0,63,0,0,0,24,0,39,0,0,63,0,63,0,0,0,24,0,39,0,0,63
2024-10-14,25éû,63,0,63,0,0,0,24,0,39,0,0,63,0,63,0,0,0,24,0,39,0,0,63
2024-10-14,25éûîº,39,0,39,0,0,0,0,0,39,0,0,39,0,39,0,0,0,0,0,39,0,0,39
2024-10-14,26éû,39,0,39,0,0,0,0,0,39,0,0,39,0,39,0,0,0,0,0,39,0,0,39
2024-10-14,26éûîº,63,0,63,0,0,0,24,0,39,0,0,63,0,63,0,0,0,24,0,39,0,0,63
2024-10-14,27éû,63,0,63,0,0,0,24,0,39,0,0,63,0,63,0,0,0,24,0,39,0,0,63
2024-10-14,27éûîº,63,0,63,0,0,0,24,0,39,0,0,63,0,63,0,0,0,24,0,39,0,0,63
2024-10-14,28éû,63,0,63,0,0,0,24,0,39,0,0,63,0,63,0,0,0,24,0,39,0,0,63
2024-10-14,28éûîº,39,0,39,0,0,0,0,0,39,0,0,39,0,39,0,0,0,0,0,39,0,0,39
2024-10-15,5éû,0,0,0,0,0,0,0,0,0,0,0,0,0,0,0,0,0,0,0,0,0,0,0
2024-10-15,5éûîº,53,29,24,0,0,0,53,0,0,0,29,24,29,24,0,0,0,53,0,0,0,29,24
2024-10-15,6éû,24,0,24,0,0,0,24,0,0,0,0,24,0,24,0,0,0,24,0,0,0,0,24
2024-10-15,6éûîº,24,0,24,0,0,0,24,0,0,0,0,24,0,24,0,0,0,24,0,0,0,0,24
2024-10-15,7éû,24,0,24,0,0,0,24,0,0,0,0,24,0,24,0,0,0,24,0,0,0,0,24
2024-10-15,7éûîº,84,60,24,0,0,60,24,0,0,0,0,84,60,24,0,0,60,24,0,0,0,0,84
2024-10-15,8éû,50,50,0,0,0,0,0,50,0,0,31,18,50,0,0,0,0,0,50,0,0,31,18
2024-10-15,8éûîº,50,50,0,0,0,0,0,50,0,0,31,18,50,0,0,0,0,0,50,0,0,31,18
2024-10-15,9éû,314,102,212,212,0,51,0,50,0,0,243,70,102,212,212,0,51,0,50,0,0,243,70
2024-10-15,9éûîº,357,101,256,212,0,96,30,18,0,0,212,145,101,256,212,0,96,30,18,0,0,212,145
2024-10-15,10éû,409,153,256,212,0,148,30,18,0,0,212,198,153,256,212,0,148,30,18,0,0,212,198
2024-10-15,10éûîº,326,70,256,212,0,96,0,18,0,0,212,115,70,256,212,0,96,0,18,0,0,212,115
2024-10-15,11éû,309,97,212,212,0,51,27,18,0,0,212,97,97,212,212,0,51,27,18,0,0,212,97
2024-10-15,11éûîº,448,112,336,212,124,51,0,18,41,0,212,236,112,336,212,124,51,0,18,41,0,212,236
2024-10-15,12éû,474,262,212,212,47,117,22,74,0,0,263,210,262,212,212,47,117,22,74,0,0,263,210
2024-10-15,12éûîº,436,185,251,297,0,51,39,47,0,0,241,196,185,251,297,0,51,39,47,0,0,241,196
2024-10-15,13éû,459,119,340,212,0,184,0,18,44,0,260,198,119,340,212,0,184,0,18,44,0,260,198
2024-10-15,13éûîº,417,121,296,212,0,102,0,18,84,0,263,154,121,296,212,0,102,0,18,84,0,263,154
2024-10-15,14éû,377,121,256,212,0,102,0,18,44,0,263,115,121,256,212,0,102,0,18,44,0,263,115
2024-10-15,14éûîº,333,121,212,212,0,102,0,18,0,0,263,70,121,212,212,0,102,0,18,0,0,263,70
2024-10-15,15éû,319,70,249,212,0,51,0,18,37,0,212,107,70,249,212,0,51,0,18,37,0,212,107
2024-10-15,15éûîº,520,271,249,212,158,51,0,18,79,0,212,308,271,249,212,158,51,0,18,79,0,212,308
2024-10-15,16éû,522,271,251,212,158,51,38,18,41,0,212,310,271,251,212,158,51,38,18,41,0,212,310
2024-10-15,16éûîº,324,112,212,212,0,51,0,18,41,0,212,112,112,212,212,0,51,0,18,41,0,212,112
2024-10-15,17éû,487,275,212,354,0,51,0,39,41,0,212,275,275,212,354,0,51,0,39,41,0,212,275
2024-10-15,17éûîº,586,374,212,354,38,51,34,65,41,0,212,374,374,212,354,38,51,34,65,41,0,212,374
2024-10-15,18éû,282,243,39,142,0,51,30,18,39,0,30,253,243,39,142,0,51,30,18,39,0,30,253
2024-10-15,18éûîº,343,133,210,170,82,51,0,0,39,0,170,173,133,210,170,82,51,0,0,39,0,170,173
2024-10-15,19éû,508,298,210,170,156,141,0,0,39,0,170,338,298,210,170,156,141,0,0,39,0,170,338
2024-10-15,19éûîº,551,341,210,170,209,90,0,0,81,0,170,380,341,210,170,209,90,0,0,81,0,170,380
2024-10-15,20éû,297,258,39,0,126,90,0,0,81,0,0,298,258,39,0,126,90,0,0,81,0,0,298
2024-10-15,20éûîº,223,184,39,0,52,90,0,0,81,0,0,223,184,39,0,52,90,0,0,81,0,0,223
2024-10-15,21éû,170,131,39,0,0,90,0,0,81,0,0,171,131,39,0,0,90,0,0,81,0,0,171
2024-10-15,21éûîº,170,131,39,0,0,90,0,0,81,0,0,171,131,39,0,0,90,0,0,81,0,0,171
2024-10-15,22éû,101,62,39,0,0,0,0,20,81,0,0,101,62,39,0,0,0,0,20,81,0,0,101
2024-10-15,22éûîº,101,62,39,0,0,0,0,20,81,0,0,101,62,39,0,0,0,0,20,81,0,0,101
2024-10-15,23éû,101,62,39,0,0,0,0,20,81,0,0,101,62,39,0,0,0,0,20,81,0,0,101
2024-10-15,23éûîº,101,62,39,0,0,0,0,20,81,0,0,101,62,39,0,0,0,0,20,81,0,0,101
2024-10-15,24éû,150,111,39,0,0,0,0,20,130,0,0,150,111,39,0,0,0,0,20,130,0,0,150
2024-10-15,24éûîº,150,111,39,0,0,0,0,20,130,0,0,150,111,39,0,0,0,0,20,130,0,0,150
2024-10-15,25éû,150,111,39,0,0,0,0,20,130,0,0,150,111,39,0,0,0,0,20,130,0,0,150
2024-10-15,25éûîº,150,111,39,0,0,0,0,20,130,0,0,150,111,39,0,0,0,0,20,130,0,0,150
2024-10-15,26éû,150,111,39,0,0,0,0,20,130,0,0,150,111,39,0,0,0,0,20,130,0,0,150
2024-10-15,26éûîº,150,111,39,0,0,0,0,20,130,0,0,150,111,39,0,0,0,0,20,130,0,0,150
2024-10-15,27éû,150,111,39,0,0,0,0,20,130,0,0,150,111,39,0,0,0,0,20,130,0,0,150
2024-10-15,27éûîº,150,111,39,0,0,0,0,20,130,0,0,150,111,39,0,0,0,0,20,130,0,0,150
2024-10-15,28éû,150,111,39,0,0,0,0,20,130,0,0,150,111,39,0,0,0,0,20,130,0,0,150
2024-10-15,28éûîº,150,111,39,0,0,0,0,20,130,0,0,150,111,39,0,0,0,0,20,130,0,0,150
2024-10-16,5éû,32,32,0,0,0,0,32,0,0,0,0,32,32,0,0,0,0,32,0,0,0,0,32
2024-10-16,5éûîº,32,32,0,0,0,0,32,0,0,0,0,32,32,0,0,0,0,32,0,0,0,0,32
2024-10-16,6éû,62,62,0,0,0,0,62,0,0,0,0,62,62,0,0,0,0,62,0,0,0,0,62
2024-10-16,6éûîº,32,32,0,0,0,0,32,0,0,0,0,32,32,0,0,0,0,32,0,0,0,0,32
2024-10-16,7éû,32,32,0,0,0,0,32,0,0,0,0,32,32,0,0,0,0,32,0,0,0,0,32
2024-10-16,7éûîº,76,32,44,0,0,0,32,0,44,0,0,76,32,44,0,0,0,32,0,44,0,0,76
2024-10-16,8éû,76,32,44,0,0,0,32,0,44,0,0,76,32,44,0,0,0,32,0,44,0,0,76
2024-10-16,8éûîº,80,80,0,0,0,48,32,0,0,0,0,80,80,0,0,0,48,32,0,0,0,0,80
2024-10-16,9éû,87,87,0,0,0,48,0,39,0,0,0,87,87,0,0,0,48,0,39,0,0,0,87
2024-10-16,9éûîº,79,39,40,0,0,0,0,79,0,0,0,79,39,40,0,0,0,0,79,0,0,0,79
2024-10-16,10éû,161,121,40,0,61,0,0,99,0,0,61,99,121,40,0,61,0,0,99,0,0,61,99
2024-10-16,10éûîº,254,214,40,0,0,124,50,79,0,0,0,254,214,40,0,0,124,50,79,0,0,0,254
2024-10-16,11éû,254,214,40,0,0,117,24,112,0,0,0,254,214,40,0,0,117,24,112,0,0,0,254
2024-10-16,11éûîº,174,174,0,0,0,89,51,33,0,0,0,174,174,0,0,0,89,51,33,0,0,0,174
2024-10-16,12éû,51,51,0,0,0,0,51,0,0,0,0,51,51,0,0,0,0,51,0,0,0,0,51
2024-10-16,12éûîº,45,45,0,0,0,0,45,0,0,0,20,24,45,0,0,0,0,45,0,0,0,20,24
2024-10-16,13éû,45,45,0,0,0,0,45,0,0,0,20,24,45,0,0,0,0,45,0,0,0,20,24
2024-10-16,13éûîº,60,24,36,0,0,0,24,0,36,0,0,61,24,36,0,0,0,24,0,36,0,0,61
2024-10-16,14éû,118,82,36,0,0,0,62,19,36,0,0,119,82,36,0,0,0,62,19,36,0,0,119
2024-10-16,14éûîº,80,44,36,0,0,0,24,19,36,0,0,81,44,36,0,0,0,24,19,36,0,0,81
2024-10-16,15éû,0,0,0,0,0,0,0,0,0,0,0,0,0,0,0,0,0,0,0,0,0,0,0
2024-10-16,15éûîº,31,31,0,0,0,0,31,0,0,0,0,31,31,0,0,0,0,31,0,0,0,0,31
2024-10-16,16éû,160,89,71,0,60,0,28,71,0,0,0,160,89,71,0,60,0,28,71,0,0,0,160
2024-10-16,16éûîº,99,28,71,0,0,0,28,71,0,0,0,100,28,71,0,0,0,28,71,0,0,0,100
2024-10-16,17éû,89,57,32,0,0,0,28,60,0,0,28,60,57,32,0,0,0,28,60,0,0,28,60
2024-10-16,17éûîº,91,57,34,0,0,0,28,62,0,0,28,62,57,34,0,0,0,28,62,0,0,28,62
2024-10-16,18éû,317,283,34,122,71,0,28,62,33,0,99,218,283,34,122,71,0,28,62,33,0,99,218
2024-10-16,18éûîº,481,304,177,265,71,0,49,62,33,0,99,382,304,177,265,71,0,49,62,33,0,99,382
2024-10-16,19éû,376,234,142,265,0,0,50,28,33,0,28,349,234,142,265,0,0,50,28,33,0,28,349
2024-10-16,19éûîº,354,212,142,265,0,0,28,28,33,0,28,327,212,142,265,0,0,28,28,33,0,28,327
2024-10-16,20éû,326,184,142,265,0,0,28,0,33,0,0,327,184,142,265,0,0,28,0,33,0,0,327
2024-10-16,20éûîº,184,184,0,122,0,0,28,0,33,0,0,184,184,0,122,0,0,28,0,33,0,0,184
2024-10-16,21éû,184,184,0,122,0,0,28,0,33,0,0,184,184,0,122,0,0,28,0,33,0,0,184
2024-10-16,21éûîº,108,108,0,0,0,46,28,0,33,0,0,108,108,0,0,0,46,28,0,33,0,0,108
2024-10-16,22éû,61,61,0,0,0,0,28,0,33,0,0,61,61,0,0,0,0,28,0,33,0,0,61
2024-10-16,22éûîº,61,61,0,0,0,0,28,0,33,0,0,61,61,0,0,0,0,28,0,33,0,0,61
2024-10-16,23éû,61,61,0,0,0,0,28,0,33,0,0,61,61,0,0,0,0,28,0,33,0,0,61
2024-10-16,23éûîº,61,61,0,0,0,0,28,0,33,0,0,61,61,0,0,0,0,28,0,33,0,0,61
2024-10-16,24éû,28,28,0,0,0,0,28,0,0,0,0,28,28,0,0,0,0,28,0,0,0,0,28
2024-10-16,24éûîº,28,28,0,0,0,0,28,0,0,0,0,28,28,0,0,0,0,28,0,0,0,0,28
2024-10-16,25éû,28,28,0,0,0,0,28,0,0,0,0,28,28,0,0,0,0,28,0,0,0,0,28
2024-10-16,25éûîº,85,85,0,0,56,0,28,0,0,0,0,85,85,0,0,56,0,28,0,0,0,0,85
2024-10-16,26éû,28,28,0,0,0,0,28,0,0,0,0,28,28,0,0,0,0,28,0,0,0,0,28
2024-10-16,26éûîº,28,28,0,0,0,0,28,0,0,0,0,28,28,0,0,0,0,28,0,0,0,0,28
2024-10-16,27éû,28,28,0,0,0,0,28,0,0,0,0,28,28,0,0,0,0,28,0,0,0,0,28
2024-10-16,27éûîº,28,28,0,0,0,0,28,0,0,0,0,28,28,0,0,0,0,28,0,0,0,0,28
2024-10-16,28éû,28,28,0,0,0,0,28,0,0,0,0,28,28,0,0,0,0,28,0,0,0,0,28
2024-10-16,28éûîº,28,28,0,0,0,0,28,0,0,0,0,28,28,0,0,0,0,28,0,0,0,0,28
2024-10-17,5éû,60,60,0,0,0,0,60,0,0,0,0,60,60,0,0,0,0,60,0,0,0,0,60
2024-10-17,5éûîº,114,83,31,0,0,0,83,31,0,0,31,83,83,31,0,0,0,83,31,0,0,31,83
2024-10-17,6éû,91,60,31,0,0,0,60,31,0,0,31,60,60,31,0,0,0,60,31,0,0,31,60
2024-10-17,6éûîº,91,60,31,0,0,0,60,31,0,0,31,60,60,31,0,0,0,60,31,0,0,31,60
2024-10-17,7éû,137,106,31,0,0,45,60,31,0,0,76,60,106,31,0,0,45,60,31,0,0,76,60
2024-10-17,7éûîº,204,173,31,0,0,90,83,31,0,0,144,60,173,31,0,0,90,83,31,0,0,144,60
2024-10-17,8éû,204,173,31,0,0,141,32,31,0,0,172,32,173,31,0,0,141,32,31,0,0,172,32
2024-10-17,8éûîº,204,173,31,0,0,141,32,31,0,0,172,32,173,31,0,0,141,32,31,0,0,172,32
2024-10-17,9éû,204,173,31,0,0,141,32,31,0,0,172,32,173,31,0,0,141,32,31,0,0,172,32
2024-10-17,9éûîº,277,246,31,0,72,141,32,31,0,0,172,104,246,31,0,72,141,32,31,0,0,172,104
2024-10-17,10éû,201,170,31,0,0,141,0,60,0,0,172,29,170,31,0,0,141,0,60,0,0,172,29
2024-10-17,10éûîº,201,170,31,0,0,141,0,60,0,0,172,29,170,31,0,0,141,0,60,0,0,172,29
2024-10-17,11éû,115,51,64,0,0,51,0,64,0,0,82,33,51,64,0,0,51,0,64,0,0,82,33
2024-10-17,11éûîº,115,51,64,0,0,51,0,64,0,0,82,33,51,64,0,0,51,0,64,0,0,82,33
2024-10-17,12éû,222,107,115,0,0,134,56,31,0,0,138,83,107,115,0,0,134,56,31,0,0,138,83
2024-10-17,12éûîº,363,332,31,109,79,51,62,31,29,0,111,251,332,31,109,79,51,62,31,29,0,111,251
2024-10-17,13éû,304,273,31,109,79,51,33,31,0,0,82,222,273,31,109,79,51,33,31,0,0,82,222
2024-10-17,13éûîº,171,140,31,0,0,51,33,57,30,0,82,89,140,31,0,0,51,33,57,30,0,82,89
2024-10-17,14éû,143,110,33,0,0,51,33,59,0,0,51,93,110,33,0,0,51,33,59,0,0,51,93
2024-10-17,14éûîº,348,126,222,222,63,0,33,28,0,0,0,349,126,222,222,63,0,33,28,0,0,0,349
2024-10-17,15éû,310,88,222,222,0,0,33,54,0,0,0,311,88,222,222,0,0,33,54,0,0,0,311
2024-10-17,15éûîº,339,117,222,222,0,0,62,54,0,0,0,340,117,222,222,0,0,62,54,0,0,0,340
2024-10-17,16éû,103,103,0,0,0,0,74,28,0,0,0,103,103,0,0,0,0,74,28,0,0,0,103
2024-10-17,16éûîº,365,189,176,176,0,38,74,28,46,0,0,365,189,176,176,0,38,74,28,46,0,0,365
2024-10-17,17éû,198,198,0,0,0,99,74,24,0,60,24,113,198,0,0,0,99,74,24,0,60,24,113
2024-10-17,17éûîº,33,33,0,0,0,0,33,0,0,0,0,33,33,0,0,0,0,33,0,0,0,0,33
2024-10-17,18éû,33,33,0,0,0,0,33,0,0,0,0,33,33,0,0,0,0,33,0,0,0,0,33
2024-10-17,18éûîº,64,64,0,0,0,0,64,0,0,0,0,64,64,0,0,0,0,64,0,0,0,0,64
2024-10-17,19éû,178,88,90,0,90,0,88,0,0,0,0,179,88,90,0,90,0,88,0,0,0,0,179
2024-10-17,19éûîº,95,95,0,0,0,0,95,0,0,0,0,95,95,0,0,0,0,95,0,0,0,0,95
2024-10-17,20éû,133,57,76,0,0,76,57,0,0,0,76,57,57,76,0,0,76,57,0,0,0,76,57
2024-10-17,20éûîº,57,57,0,0,0,0,57,0,0,0,0,57,57,0,0,0,0,57,0,0,0,0,57
2024-10-17,21éû,24,24,0,0,0,0,24,0,0,0,0,24,24,0,0,0,0,24,0,0,0,0,24
2024-10-17,21éûîº,53,53,0,0,0,0,53,0,0,0,29,24,53,0,0,0,0,53,0,0,0,29,24
2024-10-17,22éû,79,79,0,0,0,0,53,25,0,0,55,24,79,0,0,0,0,53,25,0,0,55,24
2024-10-17,22éûîº,50,50,0,0,0,0,24,25,0,0,25,24,50,0,0,0,0,24,25,0,0,25,24
2024-10-17,23éû,24,24,0,0,0,0,24,0,0,0,0,24,24,0,0,0,0,24,0,0,0,0,24
2024-10-17,23éûîº,24,24,0,0,0,0,24,0,0,0,0,24,24,0,0,0,0,24,0,0,0,0,24
2024-10-17,24éû,24,24,0,0,0,0,24,0,0,0,0,24,24,0,0,0,0,24,0,0,0,0,24
2024-10-17,24éûîº,24,24,0,0,0,0,24,0,0,0,0,24,24,0,0,0,0,24,0,0,0,0,24
2024-10-17,25éû,24,24,0,0,0,0,24,0,0,0,0,24,24,0,0,0,0,24,0,0,0,0,24
2024-10-17,25éûîº,24,24,0,0,0,0,24,0,0,0,0,24,24,0,0,0,0,24,0,0,0,0,24
2024-10-17,26éû,24,24,0,0,0,0,24,0,0,0,0,24,24,0,0,0,0,24,0,0,0,0,24
2024-10-17,26éûîº,24,24,0,0,0,0,24,0,0,0,0,24,24,0,0,0,0,24,0,0,0,0,24
2024-10-17,27éû,24,24,0,0,0,0,24,0,0,0,0,24,24,0,0,0,0,24,0,0,0,0,24
2024-10-17,27éûîº,24,24,0,0,0,0,24,0,0,0,0,24,24,0,0,0,0,24,0,0,0,0,24
2024-10-17,28éû,24,24,0,0,0,0,24,0,0,0,0,24,24,0,0,0,0,24,0,0,0,0,24
2024-10-17,28éûîº,24,24,0,0,0,0,24,0,0,0,0,24,24,0,0,0,0,24,0,0,0,0,24
2024-10-18,5éû,163,163,0,0,0,48,91,24,0,0,0,163,163,0,0,0,48,91,24,0,0,0,163
2024-10-18,5éûîº,194,163,31,0,0,48,91,55,0,0,31,163,163,31,0,0,48,91,55,0,0,31,163
2024-10-18,6éû,194,163,31,0,0,48,91,55,0,0,31,163,163,31,0,0,48,91,55,0,0,31,163
2024-10-18,6éûîº,288,257,31,0,0,100,91,55,41,0,31,257,257,31,0,0,100,91,55,41,0,31,257
2024-10-18,7éû,187,156,31,0,0,0,91,55,41,0,31,156,156,31,0,0,0,91,55,41,0,31,156
2024-10-18,7éûîº,231,200,31,0,0,43,91,55,41,0,31,200,200,31,0,0,43,91,55,41,0,31,200
2024-10-18,8éû,219,188,31,0,0,0,91,86,41,0,62,156,188,31,0,0,0,91,86,41,0,62,156
2024-10-18,8éûîº,221,156,65,0,0,0,91,89,41,0,31,190,156,65,0,0,0,91,89,41,0,31,190
2024-10-18,9éû,222,191,31,0,0,0,125,55,41,0,31,191,191,31,0,0,0,125,55,41,0,31,191
2024-10-18,9éûîº,355,324,31,126,0,38,93,55,41,0,31,324,324,31,126,0,38,93,55,41,0,31,324
2024-10-18,10éû,163,132,31,0,0,38,93,31,0,0,31,132,132,31,0,0,38,93,31,0,0,31,132
2024-10-18,10éûîº,192,161,31,0,0,67,93,31,0,0,31,161,161,31,0,0,67,93,31,0,0,31,161
2024-10-18,11éû,163,132,31,0,0,38,93,31,0,0,31,132,132,31,0,0,38,93,31,0,0,31,132
2024-10-18,11éûîº,372,244,128,109,0,64,134,64,0,0,31,341,244,128,109,0,64,134,64,0,0,31,341
2024-10-18,12éû,449,337,112,109,65,0,162,64,47,0,31,418,337,112,109,65,0,162,64,47,0,31,418
2024-10-18,12éûîº,259,195,64,0,65,0,130,64,0,0,31,228,195,64,0,65,0,130,64,0,0,31,228
2024-10-18,13éû,194,130,64,0,0,0,130,64,0,0,31,163,130,64,0,0,0,130,64,0,0,31,163
2024-10-18,13éûîº,194,130,64,0,0,0,130,64,0,0,31,163,130,64,0,0,0,130,64,0,0,31,163
2024-10-18,14éû,211,179,32,0,0,48,130,32,0,0,0,212,179,32,0,0,48,130,32,0,0,0,212
2024-10-18,14éûîº,220,172,48,0,0,15,172,32,0,0,41,179,172,48,0,0,15,172,32,0,0,41,179
2024-10-18,15éû,179,131,48,0,0,70,75,32,0,0,0,179,131,48,0,0,70,75,32,0,0,0,179
2024-10-18,15éûîº,173,97,76,0,0,15,75,82,0,0,0,174,97,76,0,0,15,75,82,0,0,0,174
2024-10-18,16éû,173,135,38,0,0,0,114,21,37,0,0,173,135,38,0,0,0,114,21,37,0,0,173
2024-10-18,16éûîº,226,188,38,0,53,0,114,21,37,0,0,227,188,38,0,53,0,114,21,37,0,0,227
2024-10-18,17éû,321,321,0,109,53,0,75,46,37,0,0,321,321,0,109,53,0,75,46,37,0,0,321
2024-10-18,17éûîº,546,315,231,340,68,0,75,24,37,231,0,315,315,231,340,68,0,75,24,37,231,0,315
2024-10-18,18éû,631,313,318,340,79,87,34,53,37,311,28,292,313,318,340,79,87,34,53,37,311,28,292
2024-10-18,18éûîº,379,61,318,231,0,87,0,24,37,231,0,148,61,318,231,0,87,0,24,37,231,0,148
2024-10-18,19éû,203,61,142,0,0,87,0,24,92,0,0,204,61,142,0,0,87,0,24,92,0,0,204
2024-10-18,19éûîº,208,121,87,0,0,147,0,24,37,0,0,208,121,87,0,0,147,0,24,37,0,0,208
2024-10-18,20éû,121,121,0,0,0,59,0,24,37,0,0,121,121,0,0,0,59,0,24,37,0,0,121
2024-10-18,20éûîº,157,157,0,0,0,96,0,24,37,0,0,157,157,0,0,0,96,0,24,37,0,0,157
2024-10-18,21éû,121,121,0,0,0,59,0,24,37,0,0,121,121,0,0,0,59,0,24,37,0,0,121
2024-10-18,21éûîº,169,83,86,0,86,59,0,24,0,0,0,169,83,86,0,86,59,0,24,0,0,0,169
2024-10-18,22éû,169,83,86,0,86,59,0,24,0,0,0,169,83,86,0,86,59,0,24,0,0,0,169
2024-10-18,22éûîº,169,83,86,0,86,59,0,24,0,0,0,169,83,86,0,86,59,0,24,0,0,0,169
2024-10-18,23éû,218,132,86,0,86,108,0,24,0,0,0,218,132,86,0,86,108,0,24,0,0,0,218
2024-10-18,23éûîº,218,132,86,0,86,108,0,24,0,0,0,218,132,86,0,86,108,0,24,0,0,0,218
2024-10-18,24éû,158,72,86,0,86,48,0,24,0,0,0,158,72,86,0,86,48,0,24,0,0,0,158
2024-10-18,24éûîº,239,153,86,0,86,129,0,24,0,0,0,239,153,86,0,86,129,0,24,0,0,0,239
2024-10-18,25éû,239,153,86,0,86,129,0,24,0,0,0,239,153,86,0,86,129,0,24,0,0,0,239
2024-10-18,25éûîº,239,153,86,0,86,129,0,24,0,0,0,239,153,86,0,86,129,0,24,0,0,0,239
2024-10-18,26éû,239,153,86,0,86,129,0,24,0,0,0,239,153,86,0,86,129,0,24,0,0,0,239
2024-10-18,26éûîº,239,153,86,0,86,129,0,24,0,0,0,239,153,86,0,86,129,0,24,0,0,0,239
2024-10-18,27éû,239,153,86,0,86,129,0,24,0,0,0,239,153,86,0,86,129,0,24,0,0,0,239
2024-10-18,27éûîº,239,153,86,0,86,129,0,24,0,0,0,239,153,86,0,86,129,0,24,0,0,0,239
2024-10-18,28éû,153,153,0,0,0,129,0,24,0,0,0,153,153,0,0,0,129,0,24,0,0,0,153
2024-10-18,28éûîº,153,153,0,0,0,129,0,24,0,0,0,153,153,0,0,0,129,0,24,0,0,0,153
2024-10-19,5éû,28,28,0,0,0,0,0,28,0,0,0,28,28,0,0,0,0,0,28,0,0,0,28
2024-10-19,5éûîº,0,0,0,0,0,0,0,0,0,0,0,0,0,0,0,0,0,0,0,0,0,0,0
2024-10-19,6éû,0,0,0,0,0,0,0,0,0,0,0,0,0,0,0,0,0,0,0,0,0,0,0
2024-10-19,6éûîº,0,0,0,0,0,0,0,0,0,0,0,0,0,0,0,0,0,0,0,0,0,0,0
2024-10-19,7éû,135,135,0,0,58,48,28,0,0,0,0,135,135,0,0,58,48,28,0,0,0,0,135
2024-10-19,7éûîº,310,310,0,175,58,48,28,0,0,0,0,310,310,0,175,58,48,28,0,0,0,0,310
2024-10-19,8éû,436,436,0,267,120,48,0,0,0,0,0,436,436,0,267,120,48,0,0,0,0,0,436
2024-10-19,8éûîº,348,348,0,134,58,120,33,0,0,0,0,348,348,0,134,58,120,33,0,0,0,0,348
2024-10-19,9éû,88,88,0,0,55,0,33,0,0,0,0,88,88,0,0,55,0,33,0,0,0,0,88
2024-10-19,9éûîº,0,0,0,0,0,0,0,0,0,0,0,0,0,0,0,0,0,0,0,0,0,0,0
2024-10-19,10éû,0,0,0,0,0,0,0,0,0,0,0,0,0,0,0,0,0,0,0,0,0,0,0
2024-10-19,10éûîº,32,0,32,0,0,0,0,32,0,0,0,32,0,32,0,0,0,0,32,0,0,0,32
2024-10-19,11éû,276,32,244,212,32,0,0,32,0,0,212,65,32,244,212,32,0,0,32,0,0,212,65
2024-10-19,11éûîº,313,32,281,212,32,69,0,0,0,0,212,101,32,281,212,32,69,0,0,0,0,212,101
2024-10-19,12éû,382,141,241,321,32,0,0,28,0,0,212,170,141,241,321,32,0,0,28,0,0,212,170
2024-10-19,12éûîº,685,444,241,428,158,0,41,57,0,0,319,366,444,241,428,158,0,41,57,0,0,319,366
2024-10-19,13éû,402,190,212,313,0,0,61,28,0,0,212,190,190,212,313,0,0,61,28,0,0,212,190
2024-10-19,13éûîº,402,190,212,313,0,0,61,28,0,0,212,190,190,212,313,0,0,61,28,0,0,212,190
2024-10-19,14éû,539,121,418,519,0,0,20,0,0,0,212,327,121,418,519,0,0,20,0,0,0,212,327
2024-10-19,14éûîº,653,441,212,559,63,0,30,0,0,0,212,441,441,212,559,63,0,30,0,0,0,212,441
2024-10-19,15éû,428,216,212,334,63,0,30,0,0,0,212,216,216,212,334,63,0,30,0,0,0,212,216
2024-10-19,15éûîº,365,153,212,334,0,0,30,0,0,0,212,153,153,212,334,0,0,30,0,0,0,212,153
2024-10-19,16éû,133,105,28,105,0,0,28,0,0,0,0,134,105,28,105,0,0,28,0,0,0,0,134
2024-10-19,16éûîº,377,227,150,105,202,42,0,26,0,0,0,377,227,150,105,202,42,0,26,0,0,0,377
2024-10-19,17éû,293,143,150,0,202,42,22,26,0,0,0,294,143,150,0,202,42,22,26,0,0,0,294
2024-10-19,17éûîº,424,284,140,122,202,44,22,32,0,0,0,424,284,140,122,202,44,22,32,0,0,0,424
2024-10-19,18éû,313,281,32,161,0,98,22,32,0,0,0,314,281,32,161,0,98,22,32,0,0,0,314
2024-10-19,18éûîº,615,539,76,161,49,225,147,32,0,0,0,616,539,76,161,49,225,147,32,0,0,0,616
2024-10-19,19éû,566,534,32,152,49,228,103,32,0,0,0,567,534,32,152,49,228,103,32,0,0,0,567
2024-10-19,19éûîº,764,554,210,362,118,120,162,0,0,0,0,764,554,210,362,118,120,162,0,0,0,0,764
2024-10-19,20éû,457,247,210,248,0,48,140,20,0,0,0,458,247,210,248,0,48,140,20,0,0,0,458
2024-10-19,20éûîº,487,277,210,248,107,48,83,0,0,0,0,487,277,210,248,107,48,83,0,0,0,0,487
2024-10-19,21éû,416,206,210,210,56,48,83,19,0,0,0,417,206,210,210,56,48,83,19,0,0,0,417
2024-10-19,21éûîº,266,205,61,54,0,48,111,51,0,0,0,266,205,61,54,0,48,111,51,0,0,0,266
2024-10-19,22éû,404,341,63,168,0,48,136,51,0,0,0,404,341,63,168,0,48,136,51,0,0,0,404
2024-10-19,22éûîº,389,282,107,168,0,48,77,96,0,0,0,390,282,107,168,0,48,77,96,0,0,0,390
2024-10-19,23éû,307,200,107,54,32,48,77,96,0,0,0,308,200,107,54,32,48,77,96,0,0,0,308
2024-10-19,23éûîº,344,237,107,54,68,48,77,96,0,0,0,345,237,107,54,68,48,77,96,0,0,0,345
2024-10-19,24éû,333,256,77,54,68,48,65,96,0,0,0,333,256,77,54,68,48,65,96,0,0,0,333
2024-10-19,24éûîº,354,277,77,54,68,48,86,96,0,0,0,354,277,77,54,68,48,86,96,0,0,0,354
2024-10-19,25éû,333,256,77,54,68,48,65,96,0,0,0,333,256,77,54,68,48,65,96,0,0,0,333
2024-10-19,25éûîº,333,256,77,54,68,48,65,96,0,0,0,333,256,77,54,68,48,65,96,0,0,0,333
2024-10-19,26éû,447,370,77,168,68,48,65,96,0,0,0,447,370,77,168,68,48,65,96,0,0,0,447
2024-10-19,26éûîº,447,370,77,168,68,48,65,96,0,0,0,447,370,77,168,68,48,65,96,0,0,0,447
2024-10-19,27éû,447,370,77,168,68,48,65,96,0,0,0,447,370,77,168,68,48,65,96,0,0,0,447
2024-10-19,27éûîº,447,370,77,168,68,48,65,96,0,0,0,447,370,77,168,68,48,65,96,0,0,0,447
2024-10-19,28éû,447,370,77,168,68,48,65,96,0,0,0,447,370,77,168,68,48,65,96,0,0,0,447
2024-10-19,28éûîº,447,370,77,168,68,48,65,96,0,0,0,447,370,77,168,68,48,65,96,0,0,0,447
2024-10-20,5éû,438,292,146,113,160,60,24,0,79,60,0,378,292,146,113,160,60,24,0,79,60,0,378
2024-10-20,5éûîº,316,170,146,113,99,0,24,0,79,0,0,317,170,146,113,99,0,24,0,79,0,0,317
2024-10-20,6éû,316,170,146,113,99,0,24,0,79,0,0,317,170,146,113,99,0,24,0,79,0,0,317
2024-10-20,6éûîº,123,56,67,0,99,0,24,0,0,0,0,123,56,67,0,99,0,24,0,0,0,0,123
2024-10-20,7éû,178,111,67,54,99,0,24,0,0,0,0,178,111,67,54,99,0,24,0,0,0,0,178
2024-10-20,7éûîº,245,178,67,0,173,48,24,0,0,0,0,245,178,67,0,173,48,24,0,0,0,0,245
2024-10-20,8éû,461,370,91,192,173,48,48,0,0,0,0,461,370,91,192,173,48,48,0,0,0,0,461
2024-10-20,8éûîº,514,423,91,114,222,93,84,0,0,0,0,515,423,91,114,222,93,84,0,0,0,0,515
2024-10-20,9éû,279,212,67,0,149,93,35,0,0,0,0,279,212,67,0,149,93,35,0,0,0,0,279
2024-10-20,9éûîº,1000,658,342,602,203,158,35,0,0,0,212,789,658,342,602,203,158,35,0,0,0,212,789
2024-10-20,10éû,1003,661,342,574,234,158,35,0,0,0,212,791,661,342,574,234,158,35,0,0,0,212,791
2024-10-20,10éûîº,806,527,279,574,180,51,0,0,0,0,212,594,527,279,574,180,51,0,0,0,0,212,594
2024-10-20,11éû,520,241,279,351,117,51,0,0,0,0,212,308,241,279,351,117,51,0,0,0,0,212,308
2024-10-20,11éûîº,314,102,212,212,50,51,0,0,0,0,212,102,102,212,212,50,51,0,0,0,0,212,102
2024-10-20,12éû,552,340,212,342,129,51,0,28,0,0,212,340,340,212,342,129,51,0,28,0,0,212,340
2024-10-20,12éûîº,529,280,249,342,129,0,20,0,37,0,212,317,280,249,342,129,0,20,0,37,0,212,317
2024-10-20,13éû,727,302,425,342,219,87,42,0,37,0,212,516,302,425,342,219,87,42,0,37,0,212,516
2024-10-20,13éûîº,657,232,425,212,219,136,22,31,37,0,212,446,232,425,212,219,136,22,31,37,0,212,446
2024-10-20,14éû,740,271,469,212,257,136,66,31,37,0,212,529,271,469,212,257,136,66,31,37,0,212,529
2024-10-20,14éûîº,737,394,343,334,168,136,66,31,0,0,212,525,394,343,334,168,136,66,31,0,0,212,525
2024-10-20,15éû,435,313,122,122,168,87,57,0,0,0,0,436,313,122,122,168,87,57,0,0,0,0,436
2024-10-20,15éûîº,396,274,122,122,129,87,57,0,0,0,0,397,274,122,122,129,87,57,0,0,0,0,397
2024-10-20,16éû,445,289,156,216,50,87,63,28,0,0,0,446,289,156,216,50,87,63,28,0,0,0,446
2024-10-20,16éûîº,540,200,340,278,50,143,41,28,0,0,0,541,200,340,278,50,143,41,28,0,0,0,541
2024-10-20,17éû,398,200,198,93,50,143,82,28,0,0,0,398,200,198,93,50,143,82,28,0,0,0,398
2024-10-20,17éûîº,206,50,156,0,50,87,41,28,0,0,0,207,50,156,0,50,87,41,28,0,0,0,207
2024-10-20,18éû,234,50,184,0,50,87,41,56,0,0,0,235,50,184,0,50,87,41,56,0,0,0,235
2024-10-20,18éûîº,202,46,156,0,0,133,41,27,0,0,0,203,46,156,0,0,133,41,27,0,0,0,203
2024-10-20,19éû,156,0,156,0,0,87,41,28,0,0,0,156,0,156,0,0,87,41,28,0,0,0,156
2024-10-20,19éûîº,156,0,156,0,0,87,41,28,0,0,0,156,0,156,0,0,87,41,28,0,0,0,156
2024-10-20,20éû,156,0,156,0,0,87,41,28,0,0,0,156,0,156,0,0,87,41,28,0,0,0,156
2024-10-20,20éûîº,355,24,331,174,0,87,65,28,0,0,0,355,24,331,174,0,87,65,28,0,0,0,355
2024-10-20,21éû,598,274,324,425,0,0,65,28,79,0,0,598,274,324,425,0,0,65,28,79,0,0,598
2024-10-20,21éûîº,280,131,149,107,0,0,65,28,79,0,0,280,131,149,107,0,0,65,28,79,0,0,280
2024-10-20,22éû,173,24,149,0,0,0,65,28,79,0,0,173,24,149,0,0,0,65,28,79,0,0,173
2024-10-20,22éûîº,173,24,149,0,0,0,65,28,79,0,0,173,24,149,0,0,0,65,28,79,0,0,173
2024-10-20,23éû,173,24,149,0,0,0,65,28,79,0,0,173,24,149,0,0,0,65,28,79,0,0,173
2024-10-20,23éûîº,173,24,149,0,0,0,65,28,79,0,0,173,24,149,0,0,0,65,28,79,0,0,173
2024-10-20,24éû,103,24,79,0,0,0,24,0,79,0,0,103,24,79,0,0,0,24,0,79,0,0,103
2024-10-20,24éûîº,103,24,79,0,0,0,24,0,79,0,0,103,24,79,0,0,0,24,0,79,0,0,103
2024-10-20,25éû,103,24,79,0,0,0,24,0,79,0,0,103,24,79,0,0,0,24,0,79,0,0,103
2024-10-20,25éûîº,103,24,79,0,0,0,24,0,79,0,0,103,24,79,0,0,0,24,0,79,0,0,103
2024-10-20,26éû,103,24,79,0,0,0,24,0,79,0,0,103,24,79,0,0,0,24,0,79,0,0,103
2024-10-20,26éûîº,103,24,79,0,0,0,24,0,79,0,0,103,24,79,0,0,0,24,0,79,0,0,103
2024-10-20,27éû,103,24,79,0,0,0,24,0,79,0,0,103,24,79,0,0,0,24,0,79,0,0,103
2024-10-20,27éûîº,103,24,79,0,0,0,24,0,79,0,0,103,24,79,0,0,0,24,0,79,0,0,103
2024-10-20,28éû,103,24,79,0,0,0,24,0,79,0,0,103,24,79,0,0,0,24,0,79,0,0,103
2024-10-20,28éûîº,103,24,79,0,0,0,24,0,79,0,0,103,24,79,0,0,0,24,0,79,0,0,103
2024-10-21,5éû,0,0,0,0,0,0,0,0,0,0,0,0,0,0,0,0,0,0,0,0,0,0,0
2024-10-21,5éûîº,0,0,0,0,0,0,0,0,0,0,0,0,0,0,0,0,0,0,0,0,0,0,0
2024-10-21,6éû,27,27,0,0,0,0,27,0,0,0,0,27,27,0,0,0,0,27,0,0,0,0,27
2024-10-21,6éûîº,106,27,79,0,0,0,27,0,79,0,0,107,27,79,0,0,0,27,0,79,0,0,107
2024-10-21,7éû,220,141,79,112,0,0,0,28,79,0,0,220,141,79,112,0,0,0,28,79,0,0,220
2024-10-21,7éûîº,305,226,79,226,0,0,0,0,79,0,0,306,226,79,226,0,0,0,0,79,0,0,306
2024-10-21,8éû,359,280,79,112,86,51,30,0,79,0,51,308,280,79,112,86,51,30,0,79,0,51,308
2024-10-21,8éûîº,167,51,116,0,0,51,36,0,79,0,87,79,51,116,0,0,51,36,0,79,0,87,79
2024-10-21,9éû,51,51,0,0,0,51,0,0,0,0,51,0,51,0,0,0,51,0,0,0,0,51,0
2024-10-21,9éûîº,0,0,0,0,0,0,0,0,0,0,0,0,0,0,0,0,0,0,0,0,0,0,0
2024-10-21,10éû,49,0,49,0,0,0,0,0,49,0,0,49,0,49,0,0,0,0,0,49,0,0,49
2024-10-21,10éûîº,48,48,0,0,0,48,0,0,0,0,0,48,48,0,0,0,48,0,0,0,0,0,48
2024-10-21,11éû,79,79,0,0,79,0,0,0,0,0,0,79,79,0,0,79,0,0,0,0,0,0,79
2024-10-21,11éûîº,29,29,0,0,0,0,29,0,0,0,29,0,29,0,0,0,0,29,0,0,0,29,0
2024-10-21,12éû,107,80,27,0,0,51,57,0,0,0,80,27,80,27,0,0,51,57,0,0,0,80,27
2024-10-21,12éûîº,27,0,27,0,0,0,27,0,0,0,0,27,0,27,0,0,0,27,0,0,0,0,27
2024-10-21,13éû,217,190,27,111,79,0,27,0,0,0,79,139,190,27,111,79,0,27,0,0,0,79,139
2024-10-21,13éûîº,190,190,0,111,79,0,0,0,0,0,79,111,190,0,111,79,0,0,0,0,0,79,111
2024-10-21,14éû,190,190,0,111,79,0,0,0,0,0,79,111,190,0,111,79,0,0,0,0,0,79,111
2024-10-21,14éûîº,190,190,0,111,79,0,0,0,0,0,79,111,190,0,111,79,0,0,0,0,0,79,111
2024-10-21,15éû,111,111,0,111,0,0,0,0,0,0,0,111,111,0,111,0,0,0,0,0,0,0,111
2024-10-21,15éûîº,56,56,0,0,0,0,30,25,0,0,0,56,56,0,0,0,0,30,25,0,0,0,56
2024-10-21,16éû,25,25,0,0,0,0,0,25,0,0,0,25,25,0,0,0,0,0,25,0,0,0,25
2024-10-21,16éûîº,54,54,0,0,0,0,0,54,0,0,28,25,54,0,0,0,0,0,54,0,0,28,25
2024-10-21,17éû,52,0,52,0,0,0,0,0,52,0,0,52,0,52,0,0,0,0,0,52,0,0,52
2024-10-21,17éûîº,0,0,0,0,0,0,0,0,0,0,0,0,0,0,0,0,0,0,0,0,0,0,0
2024-10-21,18éû,76,76,0,0,50,0,0,25,0,0,0,76,76,0,0,50,0,0,25,0,0,0,76
2024-10-21,18éûîº,50,50,0,0,50,0,0,0,0,0,0,50,50,0,0,50,0,0,0,0,0,0,50
2024-10-21,19éû,50,50,0,0,50,0,0,0,0,0,0,50,50,0,0,50,0,0,0,0,0,0,50
2024-10-21,19éûîº,50,50,0,0,50,0,0,0,0,0,0,50,50,0,0,50,0,0,0,0,0,0,50
2024-10-21,20éû,0,0,0,0,0,0,0,0,0,0,0,0,0,0,0,0,0,0,0,0,0,0,0
2024-10-21,20éûîº,49,49,0,0,0,49,0,0,0,0,0,49,49,0,0,0,49,0,0,0,0,0,49
2024-10-21,21éû,0,0,0,0,0,0,0,0,0,0,0,0,0,0,0,0,0,0,0,0,0,0,0
2024-10-21,21éûîº,0,0,0,0,0,0,0,0,0,0,0,0,0,0,0,0,0,0,0,0,0,0,0
2024-10-21,22éû,28,0,28,0,0,0,0,28,0,0,0,28,0,28,0,0,0,0,28,0,0,0,28
2024-10-21,22éûîº,50,22,28,0,0,0,22,28,0,0,0,51,22,28,0,0,0,22,28,0,0,0,51
2024-10-21,23éû,28,0,28,0,0,0,0,28,0,0,0,28,0,28,0,0,0,0,28,0,0,0,28
2024-10-21,23éûîº,28,0,28,0,0,0,0,28,0,0,0,28,0,28,0,0,0,0,28,0,0,0,28
2024-10-21,24éû,0,0,0,0,0,0,0,0,0,0,0,0,0,0,0,0,0,0,0,0,0,0,0
2024-10-21,24éûîº,0,0,0,0,0,0,0,0,0,0,0,0,0,0,0,0,0,0,0,0,0,0,0
2024-10-21,25éû,0,0,0,0,0,0,0,0,0,0,0,0,0,0,0,0,0,0,0,0,0,0,0
2024-10-21,25éûîº,0,0,0,0,0,0,0,0,0,0,0,0,0,0,0,0,0,0,0,0,0,0,0
2024-10-21,26éû,0,0,0,0,0,0,0,0,0,0,0,0,0,0,0,0,0,0,0,0,0,0,0
2024-10-21,26éûîº,0,0,0,0,0,0,0,0,0,0,0,0,0,0,0,0,0,0,0,0,0,0,0
2024-10-21,27éû,0,0,0,0,0,0,0,0,0,0,0,0,0,0,0,0,0,0,0,0,0,0,0
2024-10-21,27éûîº,0,0,0,0,0,0,0,0,0,0,0,0,0,0,0,0,0,0,0,0,0,0,0
2024-10-21,28éû,0,0,0,0,0,0,0,0,0,0,0,0,0,0,0,0,0,0,0,0,0,0,0
2024-10-21,28éûîº,0,0,0,0,0,0,0,0,0,0,0,0,0,0,0,0,0,0,0,0,0,0,0
2024-10-22,5éû,0,0,0,0,0,0,0,0,0,0,0,0,0,0,0,0,0,0,0,0,0,0,0
2024-10-22,5éûîº,23,23,0,0,0,0,23,0,0,0,0,23,23,0,0,0,0,23,0,0,0,0,23
2024-10-22,6éû,0,0,0,0,0,0,0,0,0,0,0,0,0,0,0,0,0,0,0,0,0,0,0
2024-10-22,6éûîº,0,0,0,0,0,0,0,0,0,0,0,0,0,0,0,0,0,0,0,0,0,0,0
2024-10-22,7éû,61,61,0,0,61,0,0,0,0,0,0,61,61,0,0,61,0,0,0,0,0,0,61
2024-10-22,7éûîº,458,193,265,0,275,183,0,0,0,142,194,122,193,265,0,275,183,0,0,0,142,194,122
2024-10-22,8éû,194,71,123,0,71,123,0,0,0,0,194,0,71,123,0,71,123,0,0,0,0,194,0
2024-10-22,8éûîº,0,0,0,0,0,0,0,0,0,0,0,0,0,0,0,0,0,0,0,0,0,0,0
2024-10-22,9éû,51,51,0,0,0,51,0,0,0,0,0,51,51,0,0,0,51,0,0,0,0,0,51
2024-10-22,9éûîº,51,51,0,0,0,51,0,0,0,0,0,51,51,0,0,0,51,0,0,0,0,0,51
2024-10-22,10éû,51,51,0,0,0,51,0,0,0,0,0,51,51,0,0,0,51,0,0,0,0,0,51
2024-10-22,10éûîº,95,95,0,0,0,95,0,0,0,0,0,95,95,0,0,0,95,0,0,0,0,0,95
2024-10-22,11éû,159,72,87,0,0,138,0,20,0,0,0,159,72,87,0,0,138,0,20,0,0,0,159
2024-10-22,11éûîº,441,200,241,212,0,149,30,50,0,0,242,199,200,241,212,0,149,30,50,0,0,242,199
2024-10-22,12éû,370,129,241,212,0,99,30,29,0,0,242,128,129,241,212,0,99,30,29,0,0,242,128
2024-10-22,12éûîº,340,99,241,212,0,99,0,29,0,0,212,128,99,241,212,0,99,0,29,0,0,212,128
2024-10-22,13éû,337,51,286,212,0,51,0,29,44,0,212,125,51,286,212,0,51,0,29,44,0,212,125
2024-10-22,13éûîº,337,51,286,212,0,51,0,29,44,0,212,125,51,286,212,0,51,0,29,44,0,212,125
2024-10-22,14éû,292,51,241,212,0,51,0,29,0,0,212,81,51,241,212,0,51,0,29,0,0,212,81
2024-10-22,14éûîº,442,114,328,212,62,138,0,29,0,0,274,168,114,328,212,62,138,0,29,0,0,274,168
2024-10-22,15éû,417,114,303,212,62,113,0,29,0,0,274,143,114,303,212,62,113,0,29,0,0,274,143
2024-10-22,15éûîº,417,114,303,212,62,113,0,29,0,0,274,143,114,303,212,62,113,0,29,0,0,274,143
2024-10-22,16éû,256,227,29,0,62,105,59,29,0,0,116,140,227,29,0,62,105,59,29,0,0,116,140
2024-10-22,16éûîº,243,214,29,100,62,51,0,29,0,0,62,181,214,29,100,62,51,0,29,0,0,62,181
2024-10-22,17éû,257,228,29,100,62,51,0,43,0,0,62,195,228,29,100,62,51,0,43,0,0,62,195
2024-10-22,17éûîº,307,278,29,100,62,101,0,43,0,0,62,245,278,29,100,62,101,0,43,0,0,62,245
2024-10-22,18éû,257,228,29,100,62,51,0,43,0,0,62,195,228,29,100,62,51,0,43,0,0,62,195
2024-10-22,18éûîº,412,212,200,271,0,112,0,29,0,0,231,181,212,200,271,0,112,0,29,0,0,231,181
2024-10-22,19éû,352,152,200,271,0,51,0,29,0,0,170,181,152,200,271,0,51,0,29,0,0,170,181
2024-10-22,19éûîº,300,100,200,271,0,0,0,29,0,0,170,130,100,200,271,0,0,0,29,0,0,170,130
2024-10-22,20éû,213,127,86,100,0,0,26,86,0,0,0,213,127,86,100,0,0,26,86,0,0,0,213
2024-10-22,20éûîº,159,159,0,100,0,31,26,0,0,0,0,159,159,0,100,0,31,26,0,0,0,0,159
2024-10-22,21éû,132,132,0,100,0,31,0,0,0,0,0,132,132,0,100,0,31,0,0,0,0,0,132
2024-10-22,21éûîº,132,132,0,100,0,31,0,0,0,0,0,132,132,0,100,0,31,0,0,0,0,0,132
2024-10-22,22éû,132,132,0,100,0,31,0,0,0,0,0,132,132,0,100,0,31,0,0,0,0,0,132
2024-10-22,22éûîº,132,132,0,100,0,31,0,0,0,0,0,132,132,0,100,0,31,0,0,0,0,0,132
2024-10-22,23éû,132,132,0,100,0,31,0,0,0,0,0,132,132,0,100,0,31,0,0,0,0,0,132
2024-10-22,23éûîº,132,132,0,100,0,31,0,0,0,0,0,132,132,0,100,0,31,0,0,0,0,0,132
2024-10-22,24éû,31,31,0,0,0,31,0,0,0,0,0,31,31,0,0,0,31,0,0,0,0,0,31
2024-10-22,24éûîº,31,31,0,0,0,31,0,0,0,0,0,31,31,0,0,0,31,0,0,0,0,0,31
2024-10-22,25éû,31,31,0,0,0,31,0,0,0,0,0,31,31,0,0,0,31,0,0,0,0,0,31
2024-10-22,25éûîº,31,31,0,0,0,31,0,0,0,0,0,31,31,0,0,0,31,0,0,0,0,0,31
2024-10-22,26éû,112,31,81,0,81,31,0,0,0,0,0,113,31,81,0,81,31,0,0,0,0,0,113
2024-10-22,26éûîº,112,31,81,0,81,31,0,0,0,0,0,113,31,81,0,81,31,0,0,0,0,0,113
2024-10-22,27éû,31,31,0,0,0,31,0,0,0,0,0,31,31,0,0,0,31,0,0,0,0,0,31
2024-10-22,27éûîº,31,31,0,0,0,31,0,0,0,0,0,31,31,0,0,0,31,0,0,0,0,0,31
2024-10-22,28éû,31,31,0,0,0,31,0,0,0,0,0,31,31,0,0,0,31,0,0,0,0,0,31
2024-10-22,28éûîº,31,31,0,0,0,31,0,0,0,0,0,31,31,0,0,0,31,0,0,0,0,0,31
2024-10-23,5éû,0,0,0,0,0,0,0,0,0,0,0,0,0,0,0,0,0,0,0,0,0,0,0
2024-10-23,5éûîº,0,0,0,0,0,0,0,0,0,0,0,0,0,0,0,0,0,0,0,0,0,0,0
2024-10-23,6éû,31,0,31,0,0,0,0,31,0,0,31,0,0,31,0,0,0,0,31,0,0,31,0
2024-10-23,6éûîº,31,0,31,0,0,0,0,31,0,0,31,0,0,31,0,0,0,0,31,0,0,31,0
2024-10-23,7éû,177,52,125,0,94,52,0,31,0,0,125,52,52,125,0,94,52,0,31,0,0,125,52
2024-10-23,7éûîº,151,26,125,0,94,0,26,31,0,0,125,26,26,125,0,94,0,26,31,0,0,125,26
2024-10-23,8éû,156,31,125,0,94,0,0,62,0,0,157,0,31,125,0,94,0,0,62,0,0,157,0
2024-10-23,8éûîº,156,31,125,0,94,0,0,62,0,0,157,0,31,125,0,94,0,0,62,0,0,157,0
2024-10-23,9éû,474,137,337,212,94,105,0,62,0,0,416,58,137,337,212,94,105,0,62,0,0,416,58
2024-10-23,9éûîº,517,180,337,212,94,46,75,89,0,0,441,77,180,337,212,94,46,75,89,0,0,441,77
2024-10-23,10éû,493,156,337,212,142,0,49,89,0,0,369,124,156,337,212,142,0,49,89,0,0,369,124
2024-10-23,10éûîº,389,52,337,212,94,0,20,62,0,0,369,20,52,337,212,94,0,20,62,0,0,369,20
2024-10-23,11éû,483,101,382,212,94,49,20,62,44,0,369,114,101,382,212,94,49,20,62,44,0,369,114
2024-10-23,11éûîº,571,189,382,212,94,101,56,62,44,0,398,173,189,382,212,94,101,56,62,44,0,398,173
2024-10-23,12éû,680,250,430,212,94,213,54,62,44,0,420,260,250,430,212,94,213,54,62,44,0,420,260
2024-10-23,12éûîº,607,177,430,212,94,109,44,62,84,0,369,238,177,430,212,94,109,44,62,84,0,369,238
2024-10-23,13éû,497,71,426,212,94,48,40,62,40,0,369,128,71,426,212,94,48,40,62,40,0,369,128
2024-10-23,13éûîº,459,82,377,212,94,51,40,62,0,0,369,91,82,377,212,94,51,40,62,0,0,369,91
2024-10-23,14éû,282,148,134,0,94,116,40,31,0,0,125,157,148,134,0,94,116,40,31,0,0,125,157
2024-10-23,14éûîº,319,225,94,89,94,105,0,31,0,0,125,194,225,94,89,94,105,0,31,0,0,125,194
2024-10-23,15éû,230,136,94,0,94,105,0,31,0,0,125,105,136,94,0,94,105,0,31,0,0,125,105
2024-10-23,15éûîº,226,132,94,0,94,100,0,31,0,0,125,100,132,94,0,94,100,0,31,0,0,125,100
2024-10-23,16éû,269,175,94,0,160,51,27,31,0,0,125,144,175,94,0,160,51,27,31,0,0,125,144
2024-10-23,16éûîº,238,144,94,0,160,51,27,0,0,0,94,144,144,94,0,160,51,27,0,0,0,94,144
2024-10-23,17éû,371,277,94,111,160,100,0,0,0,0,205,166,277,94,111,160,100,0,0,0,0,205,166
2024-10-23,17éûîº,260,166,94,0,160,100,0,0,0,0,94,166,166,94,0,160,100,0,0,0,0,94,166
2024-10-23,18éû,274,78,196,196,0,51,27,0,0,0,0,274,78,196,196,0,51,27,0,0,0,0,274
2024-10-23,18éûîº,399,203,196,196,63,47,59,0,31,0,0,400,203,196,196,63,47,59,0,31,0,0,400
2024-10-23,19éû,318,122,196,196,63,0,27,0,31,0,0,319,122,196,196,63,0,27,0,31,0,0,319
2024-10-23,19éûîº,318,122,196,196,63,0,27,0,31,0,0,319,122,196,196,63,0,27,0,31,0,0,319
2024-10-23,20éû,112,112,0,0,63,0,27,0,22,0,0,112,112,0,0,63,0,27,0,22,0,0,112
2024-10-23,20éûîº,85,85,0,0,63,0,0,0,22,0,0,85,85,0,0,63,0,0,0,22,0,0,85
2024-10-23,21éû,107,85,22,0,63,0,0,22,22,0,0,108,85,22,0,63,0,0,22,22,0,0,108
2024-10-23,21éûîº,107,85,22,0,63,0,0,22,22,0,0,108,85,22,0,63,0,0,22,22,0,0,108
2024-10-23,22éû,44,22,22,0,0,0,0,22,22,0,0,44,22,22,0,0,0,0,22,22,0,0,44
2024-10-23,22éûîº,125,125,0,0,55,48,0,0,22,0,0,125,125,0,0,55,48,0,0,22,0,0,125
2024-10-23,23éû,77,77,0,0,55,0,0,0,22,0,0,77,77,0,0,55,0,0,0,22,0,0,77
2024-10-23,23éûîº,77,77,0,0,55,0,0,0,22,0,0,77,77,0,0,55,0,0,0,22,0,0,77
2024-10-23,24éû,22,22,0,0,0,0,0,0,22,0,0,22,22,0,0,0,0,0,0,22,0,0,22
2024-10-23,24éûîº,22,22,0,0,0,0,0,0,22,0,0,22,22,0,0,0,0,0,0,22,0,0,22
2024-10-23,25éû,22,22,0,0,0,0,0,0,22,0,0,22,22,0,0,0,0,0,0,22,0,0,22
2024-10-23,25éûîº,22,22,0,0,0,0,0,0,22,0,0,22,22,0,0,0,0,0,0,22,0,0,22
2024-10-23,26éû,22,22,0,0,0,0,0,0,22,0,0,22,22,0,0,0,0,0,0,22,0,0,22
2024-10-23,26éûîº,22,22,0,0,0,0,0,0,22,0,0,22,22,0,0,0,0,0,0,22,0,0,22
2024-10-23,27éû,44,22,22,0,0,0,0,22,22,0,0,44,22,22,0,0,0,0,22,22,0,0,44
2024-10-23,27éûîº,44,22,22,0,0,0,0,22,22,0,0,44,22,22,0,0,0,0,22,22,0,0,44
2024-10-23,28éû,108,22,86,0,0,64,0,22,22,0,0,108,22,86,0,0,64,0,22,22,0,0,108
2024-10-23,28éûîº,44,22,22,0,0,0,0,22,22,0,0,44,22,22,0,0,0,0,22,22,0,0,44
2024-10-24,5éû,0,0,0,0,0,0,0,0,0,0,0,0,0,0,0,0,0,0,0,0,0,0,0
2024-10-24,5éûîº,32,32,0,0,0,0,32,0,0,0,0,32,32,0,0,0,0,32,0,0,0,0,32
2024-10-24,6éû,86,86,0,0,0,54,32,0,0,0,0,86,86,0,0,0,54,32,0,0,0,0,86
2024-10-24,6éûîº,32,32,0,0,0,0,32,0,0,0,0,32,32,0,0,0,0,32,0,0,0,0,32
2024-10-24,7éû,169,169,0,0,0,103,66,0,0,0,0,169,169,0,0,0,103,66,0,0,0,0,169
2024-10-24,7éûîº,171,171,0,0,0,103,32,36,0,0,36,135,171,0,0,0,103,32,36,0,0,36,135
2024-10-24,8éû,112,112,0,0,0,50,25,36,0,0,36,76,112,0,0,0,50,25,36,0,0,36,76
2024-10-24,8éûîº,272,76,196,196,0,50,25,0,0,0,0,272,76,196,196,0,50,25,0,0,0,0,272
2024-10-24,9éû,300,104,196,196,0,50,25,28,0,0,0,300,104,196,196,0,50,25,28,0,0,0,300
2024-10-24,9éûîº,383,125,258,196,0,163,0,24,0,0,51,332,125,258,196,0,163,0,24,0,0,51,332
2024-10-24,10éû,346,51,295,196,0,112,36,0,0,0,51,295,51,295,196,0,112,36,0,0,0,51,295
2024-10-24,10éûîº,368,135,233,196,62,72,36,0,0,0,51,318,135,233,196,62,72,36,0,0,0,51,318
2024-10-24,11éû,445,212,233,196,119,72,57,0,0,0,51,395,212,233,196,119,72,57,0,0,0,51,395
2024-10-24,11éûîº,540,271,269,196,119,97,93,0,33,0,51,489,271,269,196,119,97,93,0,33,0,51,489
2024-10-24,12éû,490,257,233,196,79,97,93,23,0,79,74,336,257,233,196,79,97,93,23,0,79,74,336
2024-10-24,12éûîº,650,417,233,196,200,81,148,23,0,79,145,425,417,233,196,200,81,148,23,0,79,145,425
2024-10-24,13éû,597,368,229,196,200,29,144,25,0,79,71,447,368,229,196,200,29,144,25,0,79,71,447
2024-10-24,13éûîº,538,386,152,216,150,0,171,0,0,79,71,388,386,152,216,150,0,171,0,0,79,71,388
2024-10-24,14éû,494,340,154,216,150,48,54,24,0,79,71,344,340,154,216,150,48,54,24,0,79,71,344
2024-10-24,14éûîº,439,320,119,216,150,48,0,24,0,79,71,289,320,119,216,150,48,0,24,0,79,71,289
2024-10-24,15éû,300,181,119,119,150,0,30,0,0,79,71,150,181,119,119,150,0,30,0,0,79,71,150
2024-10-24,15éûîº,316,197,119,119,150,46,0,0,0,79,117,119,197,119,119,150,46,0,0,0,79,117,119
2024-10-24,16éû,348,229,119,119,150,54,24,0,0,79,71,199,229,119,119,150,54,24,0,0,79,71,199
2024-10-24,16éûîº,365,205,160,119,150,54,40,0,0,79,71,215,205,160,119,150,54,40,0,0,79,71,215
2024-10-24,17éû,400,240,160,119,150,54,75,0,0,79,71,250,240,160,119,150,54,75,0,0,79,71,250
2024-10-24,17éûîº,324,205,119,119,150,54,0,0,0,79,71,174,205,119,119,150,54,0,0,0,79,71,174
2024-10-24,18éû,331,212,119,119,150,0,61,0,0,79,98,154,212,119,119,150,0,61,0,0,79,98,154
2024-10-24,18éûîº,230,111,119,119,79,0,32,0,0,79,0,152,111,119,119,79,0,32,0,0,79,0,152
2024-10-24,19éû,111,111,0,0,79,0,32,0,0,79,0,32,111,0,0,79,0,32,0,0,79,0,32
2024-10-24,19éûîº,111,111,0,0,79,0,32,0,0,79,0,32,111,0,0,79,0,32,0,0,79,0,32
2024-10-24,20éû,228,228,0,0,145,50,32,0,0,79,0,148,228,0,0,145,50,32,0,0,79,0,148
2024-10-24,20éûîº,204,204,0,0,145,0,58,0,0,79,0,124,204,0,0,145,0,58,0,0,79,0,124
2024-10-24,21éû,79,79,0,0,79,0,0,0,0,79,0,0,79,0,0,79,0,0,0,0,79,0,0
2024-10-24,21éûîº,0,0,0,0,0,0,0,0,0,0,0,0,0,0,0,0,0,0,0,0,0,0,0
2024-10-24,22éû,0,0,0,0,0,0,0,0,0,0,0,0,0,0,0,0,0,0,0,0,0,0,0
2024-10-24,22éûîº,0,0,0,0,0,0,0,0,0,0,0,0,0,0,0,0,0,0,0,0,0,0,0
2024-10-24,23éû,0,0,0,0,0,0,0,0,0,0,0,0,0,0,0,0,0,0,0,0,0,0,0
2024-10-24,23éûîº,0,0,0,0,0,0,0,0,0,0,0,0,0,0,0,0,0,0,0,0,0,0,0
2024-10-24,24éû,0,0,0,0,0,0,0,0,0,0,0,0,0,0,0,0,0,0,0,0,0,0,0
2024-10-24,24éûîº,0,0,0,0,0,0,0,0,0,0,0,0,0,0,0,0,0,0,0,0,0,0,0
2024-10-24,25éû,0,0,0,0,0,0,0,0,0,0,0,0,0,0,0,0,0,0,0,0,0,0,0
2024-10-24,25éûîº,0,0,0,0,0,0,0,0,0,0,0,0,0,0,0,0,0,0,0,0,0,0,0
2024-10-24,26éû,0,0,0,0,0,0,0,0,0,0,0,0,0,0,0,0,0,0,0,0,0,0,0
2024-10-24,26éûîº,0,0,0,0,0,0,0,0,0,0,0,0,0,0,0,0,0,0,0,0,0,0,0
2024-10-24,27éû,0,0,0,0,0,0,0,0,0,0,0,0,0,0,0,0,0,0,0,0,0,0,0
2024-10-24,27éûîº,0,0,0,0,0,0,0,0,0,0,0,0,0,0,0,0,0,0,0,0,0,0,0
2024-10-24,28éû,0,0,0,0,0,0,0,0,0,0,0,0,0,0,0,0,0,0,0,0,0,0,0
2024-10-24,28éûîº,0,0,0,0,0,0,0,0,0,0,0,0,0,0,0,0,0,0,0,0,0,0,0
2024-10-25,5éû,0,0,0,0,0,0,0,0,0,0,0,0,0,0,0,0,0,0,0,0,0,0,0
2024-10-25,5éûîº,0,0,0,0,0,0,0,0,0,0,0,0,0,0,0,0,0,0,0,0,0,0,0
2024-10-25,6éû,22,22,0,0,0,0,0,22,0,0,0,22,22,0,0,0,0,0,22,0,0,0,22
2024-10-25,6éûîº,0,0,0,0,0,0,0,0,0,0,0,0,0,0,0,0,0,0,0,0,0,0,0
2024-10-25,7éû,0,0,0,0,0,0,0,0,0,0,0,0,0,0,0,0,0,0,0,0,0,0,0
2024-10-25,7éûîº,51,51,0,0,0,51,0,0,0,0,0,51,51,0,0,0,51,0,0,0,0,0,51
2024-10-25,8éû,51,51,0,0,0,51,0,0,0,0,0,51,51,0,0,0,51,0,0,0,0,0,51
2024-10-25,8éûîº,29,29,0,0,0,0,29,0,0,0,0,29,29,0,0,0,0,29,0,0,0,0,29
2024-10-25,9éû,255,255,0,225,0,0,29,0,0,0,0,255,255,0,225,0,0,29,0,0,0,0,255
2024-10-25,9éûîº,218,218,0,0,63,101,0,53,0,0,0,218,218,0,0,63,101,0,53,0,0,0,218
2024-10-25,10éû,218,218,0,0,109,55,27,26,0,0,0,218,218,0,0,109,55,27,26,0,0,0,218
2024-10-25,10éûîº,201,201,0,0,63,55,57,26,0,0,0,201,201,0,0,63,55,57,26,0,0,0,201
2024-10-25,11éû,287,287,0,169,63,55,0,0,0,0,0,287,287,0,169,63,55,0,0,0,0,0,287
2024-10-25,11éûîº,725,486,239,381,128,105,57,53,0,0,242,483,486,239,381,128,105,57,53,0,0,242,483
2024-10-25,12éû,702,490,212,381,128,139,27,25,0,0,212,490,490,212,381,128,139,27,25,0,0,212,490
2024-10-25,12éûîº,467,255,212,212,138,89,27,0,0,0,212,255,255,212,212,138,89,27,0,0,0,212,255
2024-10-25,13éû,433,221,212,212,138,55,27,0,0,0,212,221,221,212,212,138,55,27,0,0,0,212,221
2024-10-25,13éûîº,420,208,212,212,138,0,0,69,0,0,212,208,208,212,212,138,0,0,69,0,0,212,208
2024-10-25,14éû,281,69,212,212,0,0,0,69,0,0,212,69,69,212,212,0,0,0,69,0,0,212,69
2024-10-25,14éûîº,459,247,212,212,58,45,41,69,31,0,212,247,247,212,212,58,45,41,69,31,0,212,247
2024-10-25,15éû,399,187,212,212,58,47,41,39,0,0,212,187,187,212,212,58,47,41,39,0,0,212,187
2024-10-25,15éûîº,270,58,212,212,58,0,0,0,0,0,212,58,58,212,212,58,0,0,0,0,0,212,58
2024-10-25,16éû,270,58,212,212,58,0,0,0,0,0,212,58,58,212,212,58,0,0,0,0,0,212,58
2024-10-25,16éûîº,240,28,212,212,0,0,28,0,0,0,212,28,28,212,212,0,0,28,0,0,0,212,28
2024-10-25,17éû,49,49,0,0,0,49,0,0,0,0,0,49,49,0,0,0,49,0,0,0,0,0,49
2024-10-25,17éûîº,155,155,0,0,0,155,0,0,0,0,0,155,155,0,0,0,155,0,0,0,0,0,155
2024-10-25,18éû,296,179,117,0,117,149,0,0,30,0,0,296,179,117,0,117,149,0,0,30,0,0,296
2024-10-25,18éûîº,231,231,0,0,63,167,0,0,0,0,0,231,231,0,0,63,167,0,0,0,0,0,231
2024-10-25,19éû,230,230,0,0,63,99,34,31,0,0,0,230,230,0,0,63,99,34,31,0,0,0,230
2024-10-25,19éûîº,98,98,0,0,63,0,34,0,0,0,0,98,98,0,0,63,0,34,0,0,0,0,98
2024-10-25,20éû,93,93,0,0,0,58,34,0,0,0,0,93,93,0,0,0,58,34,0,0,0,0,93
2024-10-25,20éûîº,125,125,0,0,0,58,66,0,0,0,0,125,125,0,0,0,58,66,0,0,0,0,125
2024-10-25,21éû,298,298,0,172,0,58,66,0,0,0,0,298,298,0,172,0,58,66,0,0,0,0,298
2024-10-25,21éûîº,440,298,142,172,142,58,66,0,0,142,0,298,298,142,172,142,58,66,0,0,142,0,298
2024-10-25,22éû,266,266,0,172,0,58,34,0,0,0,0,266,266,0,172,0,58,34,0,0,0,0,266
2024-10-25,22éûîº,34,34,0,0,0,0,34,0,0,0,0,34,34,0,0,0,0,34,0,0,0,0,34
2024-10-25,23éû,34,34,0,0,0,0,34,0,0,0,0,34,34,0,0,0,0,34,0,0,0,0,34
2024-10-25,23éûîº,0,0,0,0,0,0,0,0,0,0,0,0,0,0,0,0,0,0,0,0,0,0,0
2024-10-25,24éû,85,85,0,0,0,60,0,25,0,0,0,85,85,0,0,0,60,0,25,0,0,0,85
2024-10-25,24éûîº,0,0,0,0,0,0,0,0,0,0,0,0,0,0,0,0,0,0,0,0,0,0,0
2024-10-25,25éû,0,0,0,0,0,0,0,0,0,0,0,0,0,0,0,0,0,0,0,0,0,0,0
2024-10-25,25éûîº,0,0,0,0,0,0,0,0,0,0,0,0,0,0,0,0,0,0,0,0,0,0,0
2024-10-25,26éû,0,0,0,0,0,0,0,0,0,0,0,0,0,0,0,0,0,0,0,0,0,0,0
2024-10-25,26éûîº,0,0,0,0,0,0,0,0,0,0,0,0,0,0,0,0,0,0,0,0,0,0,0
2024-10-25,27éû,0,0,0,0,0,0,0,0,0,0,0,0,0,0,0,0,0,0,0,0,0,0,0
2024-10-25,27éûîº,0,0,0,0,0,0,0,0,0,0,0,0,0,0,0,0,0,0,0,0,0,0,0
2024-10-25,28éû,0,0,0,0,0,0,0,0,0,0,0,0,0,0,0,0,0,0,0,0,0,0,0
2024-10-25,28éûîº,0,0,0,0,0,0,0,0,0,0,0,0,0,0,0,0,0,0,0,0,0,0,0
2024-10-26,5éû,0,0,0,0,0,0,0,0,0,0,0,0,0,0,0,0,0,0,0,0,0,0,0
2024-10-26,5éûîº,0,0,0,0,0,0,0,0,0,0,0,0,0,0,0,0,0,0,0,0,0,0,0
2024-10-26,6éû,54,54,0,0,0,31,0,22,0,0,0,54,54,0,0,0,31,0,22,0,0,0,54
2024-10-26,6éûîº,0,0,0,0,0,0,0,0,0,0,0,0,0,0,0,0,0,0,0,0,0,0,0
2024-10-26,7éû,24,0,24,0,0,0,24,0,0,0,0,24,0,24,0,0,0,24,0,0,0,0,24
2024-10-26,7éûîº,24,0,24,0,0,0,24,0,0,0,0,24,0,24,0,0,0,24,0,0,0,0,24
2024-10-26,8éû,24,0,24,0,0,0,24,0,0,0,0,24,0,24,0,0,0,24,0,0,0,0,24
2024-10-26,8éûîº,24,0,24,0,0,0,24,0,0,0,0,24,0,24,0,0,0,24,0,0,0,0,24
2024-10-26,9éû,0,0,0,0,0,0,0,0,0,0,0,0,0,0,0,0,0,0,0,0,0,0,0
2024-10-26,9éûîº,324,112,212,212,66,46,0,0,0,0,212,112,112,212,212,66,46,0,0,0,0,212,112
2024-10-26,10éû,212,0,212,212,0,0,0,0,0,0,212,0,0,212,212,0,0,0,0,0,0,212,0
2024-10-26,10éûîº,366,60,306,212,94,60,0,0,0,0,212,154,60,306,212,94,60,0,0,0,0,212,154
2024-10-26,11éû,306,0,306,212,94,0,0,0,0,0,212,94,0,306,212,94,0,0,0,0,0,212,94
2024-10-26,11éûîº,286,0,286,286,0,0,0,0,0,0,212,74,0,286,286,0,0,0,0,0,0,212,74
2024-10-26,12éû,238,0,238,212,0,0,26,0,0,0,212,26,0,238,212,0,0,26,0,0,0,212,26
2024-10-26,12éûîº,212,0,212,212,0,0,0,0,0,0,212,0,0,212,212,0,0,0,0,0,0,212,0
2024-10-26,13éû,446,0,446,212,234,0,0,0,0,0,212,234,0,446,212,234,0,0,0,0,0,212,234
2024-10-26,13éûîº,633,0,633,399,234,0,0,0,0,0,212,421,0,633,399,234,0,0,0,0,0,212,421
2024-10-26,14éû,706,73,633,399,284,0,0,23,0,0,212,495,73,633,399,284,0,0,23,0,0,212,495
2024-10-26,14éûîº,614,130,484,212,341,0,37,23,0,0,212,402,130,484,212,341,0,37,23,0,0,212,402
2024-10-26,15éû,539,55,484,212,234,0,69,23,0,0,243,295,55,484,212,234,0,69,23,0,0,243,295
2024-10-26,15éûîº,576,92,484,212,234,37,69,23,0,0,243,332,92,484,212,234,37,69,23,0,0,243,332
2024-10-26,16éû,413,141,272,0,284,37,69,23,0,0,31,382,141,272,0,284,37,69,23,0,0,31,382
2024-10-26,16éûîº,462,117,345,0,308,59,61,33,0,0,0,463,117,345,0,308,59,61,33,0,0,0,463
2024-10-26,17éû,438,93,345,0,308,59,37,33,0,0,0,439,93,345,0,308,59,37,33,0,0,0,439
2024-10-26,17éûîº,666,184,482,0,373,139,133,21,0,0,0,667,184,482,0,373,139,133,21,0,0,0,667
2024-10-26,18éû,627,250,377,0,373,139,93,21,0,0,0,628,250,377,0,373,139,93,21,0,0,0,628
2024-10-26,18éûîº,592,184,408,0,308,139,93,21,30,0,0,593,184,408,0,308,139,93,21,30,0,0,593
2024-10-26,19éû,512,208,304,0,234,139,93,45,0,0,0,513,208,304,0,234,139,93,45,0,0,0,513
2024-10-26,19éûîº,488,184,304,0,234,139,69,45,0,0,0,489,184,304,0,234,139,69,45,0,0,0,489
2024-10-26,20éû,488,184,304,0,234,139,69,45,0,0,0,489,184,304,0,234,139,69,45,0,0,0,489
2024-10-26,20éûîº,383,79,304,0,234,79,69,0,0,0,0,383,79,304,0,234,79,69,0,0,0,0,383
2024-10-26,21éû,348,79,269,199,0,79,69,0,0,0,0,348,79,269,199,0,79,69,0,0,0,0,348
2024-10-26,21éûîº,437,79,358,199,89,79,69,0,0,0,0,437,79,358,199,89,79,69,0,0,0,0,437
2024-10-26,22éû,234,35,199,0,89,76,69,0,0,0,0,235,35,199,0,89,76,69,0,0,0,0,235
2024-10-26,22éûîº,234,35,199,0,89,76,69,0,0,0,0,235,35,199,0,89,76,69,0,0,0,0,235
2024-10-26,23éû,425,70,355,225,89,76,34,0,0,0,0,425,70,355,225,89,76,34,0,0,0,0,425
2024-10-26,23éûîº,390,35,355,225,89,76,0,0,0,0,0,391,35,355,225,89,76,0,0,0,0,0,391
2024-10-26,24éû,423,0,423,225,157,40,0,0,0,0,0,423,0,423,225,157,40,0,0,0,0,0,423
2024-10-26,24éûîº,423,0,423,225,157,40,0,0,0,0,0,423,0,423,225,157,40,0,0,0,0,0,423
2024-10-26,25éû,423,0,423,225,157,40,0,0,0,0,0,423,0,423,225,157,40,0,0,0,0,0,423
2024-10-26,25éûîº,423,0,423,225,157,40,0,0,0,0,0,423,0,423,225,157,40,0,0,0,0,0,423
2024-10-26,26éû,423,0,423,225,157,40,0,0,0,0,0,423,0,423,225,157,40,0,0,0,0,0,423
2024-10-26,26éûîº,423,0,423,225,157,40,0,0,0,0,0,423,0,423,225,157,40,0,0,0,0,0,423
2024-10-26,27éû,423,0,423,225,157,40,0,0,0,0,0,423,0,423,225,157,40,0,0,0,0,0,423
2024-10-26,27éûîº,423,0,423,225,157,40,0,0,0,0,0,423,0,423,225,157,40,0,0,0,0,0,423
2024-10-26,28éû,423,0,423,225,157,40,0,0,0,0,0,423,0,423,225,157,40,0,0,0,0,0,423
2024-10-26,28éûîº,423,0,423,225,157,40,0,0,0,0,0,423,0,423,225,157,40,0,0,0,0,0,423
2024-10-27,5éû,384,70,314,225,29,93,0,36,0,0,0,384,70,314,225,29,93,0,36,0,0,0,384
2024-10-27,5éûîº,183,41,142,0,54,93,0,36,0,0,0,183,41,142,0,54,93,0,36,0,0,0,183
2024-10-27,6éû,207,41,166,0,77,93,0,36,0,0,0,207,41,166,0,77,93,0,36,0,0,0,207
2024-10-27,6éûîº,522,41,481,135,226,93,0,67,0,0,31,491,41,481,135,226,93,0,67,0,0,31,491
2024-10-27,7éû,240,65,175,0,56,93,0,91,0,0,31,209,65,175,0,56,93,0,91,0,0,31,209
2024-10-27,7éûîº,228,41,187,0,68,93,0,67,0,0,31,197,41,187,0,68,93,0,67,0,0,31,197
2024-10-27,8éû,456,138,318,97,154,137,0,67,0,0,31,426,138,318,97,154,137,0,67,0,0,31,426
2024-10-27,8éûîº,461,97,364,97,244,51,0,67,0,0,31,430,97,364,97,244,51,0,67,0,0,31,430
2024-10-27,9éû,786,214,572,289,318,51,28,67,30,0,31,755,214,572,289,318,51,28,67,30,0,31,755
2024-10-27,9éûîº,588,154,434,97,351,51,26,31,30,0,31,557,154,434,97,351,51,26,31,30,0,31,557
2024-10-27,10éû,341,111,230,111,74,124,0,31,0,0,31,310,111,230,111,74,124,0,31,0,0,31,310
2024-10-27,10éûîº,394,0,394,164,74,124,0,31,0,0,31,363,0,394,164,74,124,0,31,0,0,31,363
2024-10-27,11éû,320,0,320,199,0,51,0,31,37,0,31,289,0,320,199,0,51,0,31,37,0,31,289
2024-10-27,11éûîº,181,30,151,0,0,119,30,31,0,0,31,150,30,151,0,0,119,30,31,0,0,31,150
2024-10-27,12éû,95,0,95,0,0,63,0,31,0,0,31,63,0,95,0,0,63,0,31,0,0,31,63
2024-10-27,12éûîº,274,51,223,0,0,243,0,31,0,0,31,243,51,223,0,0,243,0,31,0,0,31,243
2024-10-27,13éû,286,0,286,0,139,114,0,31,0,0,31,254,0,286,0,139,114,0,31,0,0,31,254
2024-10-27,13éûîº,278,0,278,0,132,114,0,31,0,0,31,247,0,278,0,132,114,0,31,0,0,31,247
2024-10-27,14éû,226,29,197,0,162,0,33,31,0,0,31,195,29,197,0,162,0,33,31,0,0,31,195
2024-10-27,14éûîº,148,29,119,0,29,119,0,0,0,0,0,148,29,119,0,29,119,0,0,0,0,0,148
2024-10-27,15éû,199,85,114,0,29,68,46,25,30,0,0,199,85,114,0,29,68,46,25,30,0,0,199
2024-10-27,15éûîº,445,29,416,199,120,0,86,0,39,0,0,445,29,416,199,120,0,86,0,39,0,0,445
2024-10-27,16éû,605,29,576,199,284,75,46,0,0,0,0,606,29,576,199,284,75,46,0,0,0,0,606
2024-10-27,16éûîº,479,60,419,199,127,75,77,0,0,0,0,480,60,419,199,127,75,77,0,0,0,0,480
2024-10-27,17éû,645,60,585,199,241,129,77,0,0,0,0,646,60,585,199,241,129,77,0,0,0,0,646
2024-10-27,17éûîº,735,60,675,199,384,75,77,0,0,0,0,736,60,675,199,384,75,77,0,0,0,0,736
2024-10-27,18éû,891,30,861,431,354,75,30,0,0,231,0,660,30,861,431,354,75,30,0,0,231,0,660
2024-10-27,18éûîº,629,0,629,199,354,75,0,0,0,0,0,629,0,629,199,354,75,0,0,0,0,0,629
2024-10-27,19éû,553,0,553,199,354,0,0,0,0,0,0,553,0,553,199,354,0,0,0,0,0,0,553
2024-10-27,19éûîº,455,0,455,199,256,0,0,0,0,0,0,455,0,455,199,256,0,0,0,0,0,0,455
2024-10-27,20éû,540,41,499,156,342,41,0,0,0,0,0,540,41,499,156,342,41,0,0,0,0,0,540
2024-10-27,20éûîº,331,41,290,156,134,41,0,0,0,0,0,332,41,290,156,134,41,0,0,0,0,0,332
2024-10-27,21éû,89,41,48,0,48,41,0,0,0,0,0,89,41,48,0,48,41,0,0,0,0,0,89
2024-10-27,21éûîº,41,41,0,0,0,41,0,0,0,0,0,41,41,0,0,0,41,0,0,0,0,0,41
2024-10-27,22éû,70,70,0,0,29,41,0,0,0,0,0,70,70,0,0,29,41,0,0,0,0,0,70
2024-10-27,22éûîº,70,70,0,0,29,41,0,0,0,0,0,70,70,0,0,29,41,0,0,0,0,0,70
2024-10-27,23éû,70,70,0,0,29,41,0,0,0,0,0,70,70,0,0,29,41,0,0,0,0,0,70
2024-10-27,23éûîº,70,70,0,0,29,41,0,0,0,0,0,70,70,0,0,29,41,0,0,0,0,0,70
2024-10-27,24éû,70,70,0,0,29,41,0,0,0,0,0,70,70,0,0,29,41,0,0,0,0,0,70
2024-10-27,24éûîº,158,70,88,0,29,93,0,36,0,0,0,159,70,88,0,29,93,0,36,0,0,0,159
2024-10-27,25éû,158,70,88,0,29,93,0,36,0,0,0,159,70,88,0,29,93,0,36,0,0,0,159
2024-10-27,25éûîº,251,70,181,0,122,93,0,36,0,0,0,252,70,181,0,122,93,0,36,0,0,0,252
2024-10-27,26éû,251,70,181,0,122,93,0,36,0,0,0,252,70,181,0,122,93,0,36,0,0,0,252
2024-10-27,26éûîº,251,70,181,0,122,93,0,36,0,0,0,252,70,181,0,122,93,0,36,0,0,0,252
2024-10-27,27éû,251,70,181,0,122,93,0,36,0,0,0,252,70,181,0,122,93,0,36,0,0,0,252
2024-10-27,27éûîº,251,70,181,0,122,93,0,36,0,0,0,252,70,181,0,122,93,0,36,0,0,0,252
2024-10-27,28éû,158,70,88,0,29,93,0,36,0,0,0,159,70,88,0,29,93,0,36,0,0,0,159
2024-10-27,28éûîº,158,70,88,0,29,93,0,36,0,0,0,159,70,88,0,29,93,0,36,0,0,0,159
2024-10-28,5éû,0,0,0,0,0,0,0,0,0,0,0,0,0,0,0,0,0,0,0,0,0,0,0
2024-10-28,5éûîº,31,0,31,0,0,0,0,31,0,0,31,0,0,31,0,0,0,0,31,0,0,31,0
2024-10-28,6éû,31,0,31,0,0,0,0,31,0,0,31,0,0,31,0,0,0,0,31,0,0,31,0
2024-10-28,6éûîº,31,0,31,0,0,0,0,31,0,0,31,0,0,31,0,0,0,0,31,0,0,31,0
2024-10-28,7éû,59,28,31,0,0,0,0,59,0,0,31,28,28,31,0,0,0,0,59,0,0,31,28
2024-10-28,7éûîº,83,52,31,0,0,52,0,31,0,0,31,52,52,31,0,0,52,0,31,0,0,31,52
2024-10-28,8éû,31,0,31,0,0,0,0,31,0,0,31,0,0,31,0,0,0,0,31,0,0,31,0
2024-10-28,8éûîº,31,0,31,0,0,0,0,31,0,0,31,0,0,31,0,0,0,0,31,0,0,31,0
2024-10-28,9éû,77,46,31,0,0,46,0,31,0,0,78,0,46,31,0,0,46,0,31,0,0,78,0
2024-10-28,9éûîº,64,33,31,0,0,0,0,31,33,0,64,0,33,31,0,0,0,0,31,33,0,64,0
2024-10-28,10éû,65,0,65,0,0,0,0,65,0,0,31,34,0,65,0,0,0,0,65,0,0,31,34
2024-10-28,10éûîº,65,0,65,0,0,0,0,65,0,0,31,34,0,65,0,0,0,0,65,0,0,31,34
2024-10-28,11éû,65,0,65,0,0,0,0,65,0,0,31,34,0,65,0,0,0,0,65,0,0,31,34
2024-10-28,11éûîº,102,71,31,0,0,51,20,31,0,0,82,20,71,31,0,0,51,20,31,0,0,82,20
2024-10-28,12éû,102,71,31,0,0,51,20,31,0,0,82,20,71,31,0,0,51,20,31,0,0,82,20
2024-10-28,12éûîº,286,43,243,212,0,0,43,31,0,0,243,43,43,243,212,0,0,43,31,0,0,243,43
2024-10-28,13éû,419,176,243,323,0,0,64,31,0,0,264,155,176,243,323,0,0,64,31,0,0,264,155
2024-10-28,13éûîº,388,176,212,323,0,0,64,0,0,0,232,155,176,212,323,0,0,64,0,0,0,232,155
2024-10-28,14éû,362,150,212,323,0,0,20,18,0,0,212,150,150,212,323,0,0,20,18,0,0,212,150
2024-10-28,14éûîº,475,263,212,436,0,0,20,18,0,0,212,263,263,212,436,0,0,20,18,0,0,212,263
2024-10-28,15éû,457,245,212,436,0,0,20,0,0,0,212,245,245,212,436,0,0,20,0,0,0,212,245
2024-10-28,15éûîº,351,139,212,323,0,27,0,0,0,0,212,139,139,212,323,0,27,0,0,0,0,212,139
2024-10-28,16éû,396,184,212,323,0,72,0,0,0,0,212,184,184,212,323,0,72,0,0,0,0,212,184
2024-10-28,16éûîº,742,184,558,596,73,72,0,0,0,0,0,742,184,558,596,73,72,0,0,0,0,0,742
2024-10-28,17éû,668,184,484,596,0,72,0,0,0,0,0,669,184,484,596,0,72,0,0,0,0,0,669
2024-10-28,17éûîº,177,177,0,111,0,44,20,0,0,0,0,177,177,0,111,0,44,20,0,0,0,0,177
2024-10-28,18éû,177,177,0,111,0,44,20,0,0,0,0,177,177,0,111,0,44,20,0,0,0,0,177
2024-10-28,18éûîº,177,177,0,111,0,44,20,0,0,0,0,177,177,0,111,0,44,20,0,0,0,0,177
2024-10-28,19éû,177,177,0,111,0,44,20,0,0,0,0,177,177,0,111,0,44,20,0,0,0,0,177
2024-10-28,19éûîº,177,177,0,111,0,44,20,0,0,0,0,177,177,0,111,0,44,20,0,0,0,0,177
2024-10-28,20éû,270,234,36,111,0,44,77,36,0,0,30,240,234,36,111,0,44,77,36,0,0,30,240
2024-10-28,20éûîº,239,203,36,111,0,44,47,36,0,0,0,240,203,36,111,0,44,47,36,0,0,0,240
2024-10-28,21éû,213,177,36,111,0,44,20,36,0,0,0,213,177,36,111,0,44,20,36,0,0,0,213
2024-10-28,21éûîº,213,177,36,111,0,44,20,36,0,0,0,213,177,36,111,0,44,20,36,0,0,0,213
2024-10-28,22éû,757,237,520,596,0,105,20,36,0,60,60,698,237,520,596,0,105,20,36,0,60,60,698
2024-10-28,22éûîº,757,237,520,596,0,105,20,36,0,60,60,698,237,520,596,0,105,20,36,0,60,60,698
2024-10-28,23éû,779,237,542,596,0,105,42,36,0,60,60,720,237,542,596,0,105,42,36,0,60,60,720
2024-10-28,23éûîº,779,237,542,596,0,105,42,36,0,60,60,720,237,542,596,0,105,42,36,0,60,60,720
2024-10-28,24éû,779,237,542,596,0,105,42,36,0,60,60,720,237,542,596,0,105,42,36,0,60,60,720
2024-10-28,24éûîº,779,237,542,596,0,105,42,36,0,60,60,720,237,542,596,0,105,42,36,0,60,60,720
2024-10-28,25éû,719,177,542,596,0,44,42,36,0,0,0,720,177,542,596,0,44,42,36,0,0,0,720
2024-10-28,25éûîº,779,237,542,596,0,105,42,36,0,60,60,720,237,542,596,0,105,42,36,0,60,60,720
2024-10-28,26éû,779,237,542,596,0,105,42,36,0,60,60,720,237,542,596,0,105,42,36,0,60,60,720
2024-10-28,26éûîº,779,237,542,596,0,105,42,36,0,60,60,720,237,542,596,0,105,42,36,0,60,60,720
2024-10-28,27éû,734,192,542,596,0,60,42,36,0,60,60,675,192,542,596,0,60,42,36,0,60,60,675
2024-10-28,27éûîº,734,192,542,596,0,60,42,36,0,60,60,675,192,542,596,0,60,42,36,0,60,60,675
2024-10-28,28éû,734,192,542,596,0,60,42,36,0,60,60,675,192,542,596,0,60,42,36,0,60,60,675
2024-10-28,28éûîº,734,192,542,596,0,60,42,36,0,60,60,675,192,542,596,0,60,42,36,0,60,60,675
2024-10-29,5éû,132,132,0,111,0,0,20,0,0,0,0,132,132,0,111,0,0,20,0,0,0,0,132
2024-10-29,5éûîº,162,162,0,111,0,0,50,0,0,0,0,162,162,0,111,0,0,50,0,0,0,0,162
2024-10-29,6éû,207,207,0,111,0,44,50,0,0,0,0,207,207,0,111,0,44,50,0,0,0,0,207
2024-10-29,6éûîº,207,207,0,111,0,44,50,0,0,0,0,207,207,0,111,0,44,50,0,0,0,0,207
2024-10-29,7éû,207,207,0,111,0,44,50,0,0,0,0,207,207,0,111,0,44,50,0,0,0,0,207
2024-10-29,7éûîº,255,255,0,111,0,93,50,0,0,0,0,255,255,0,111,0,93,50,0,0,0,0,255
2024-10-29,8éû,401,274,127,111,67,172,50,0,0,0,127,274,274,127,111,67,172,50,0,0,0,127,274
2024-10-29,8éûîº,269,269,0,111,67,44,20,24,0,0,0,269,269,0,111,67,44,20,24,0,0,0,269
2024-10-29,9éû,272,272,0,111,67,44,47,0,0,0,0,272,272,0,111,67,44,47,0,0,0,0,272
2024-10-29,9éûîº,436,224,212,323,67,44,0,0,0,0,212,224,224,212,323,67,44,0,0,0,0,212,224
2024-10-29,10éû,364,112,252,212,67,44,0,0,40,0,212,152,112,252,212,67,44,0,0,40,0,212,152
2024-10-29,10éûîº,324,112,212,212,67,44,0,0,0,0,212,112,112,212,212,67,44,0,0,0,0,212,112
2024-10-29,11éû,398,139,259,212,67,44,27,0,47,0,212,187,139,259,212,67,44,27,0,47,0,212,187
2024-10-29,11éûîº,443,184,259,212,67,44,71,0,47,0,212,232,184,259,212,67,44,71,0,47,0,212,232
2024-10-29,12éû,348,109,239,212,0,44,91,0,0,0,262,86,109,239,212,0,44,91,0,0,0,262,86
2024-10-29,12éûîº,597,358,239,351,0,99,147,0,0,0,318,279,358,239,351,0,99,147,0,0,0,318,279
2024-10-29,13éû,402,163,239,212,0,44,126,19,0,0,242,160,163,239,212,0,44,126,19,0,0,242,160
2024-10-29,13éûîº,348,136,212,212,0,44,72,19,0,0,242,106,136,212,212,0,44,72,19,0,0,242,106
2024-10-29,14éû,318,106,212,212,0,44,41,19,0,0,212,106,106,212,212,0,44,41,19,0,0,212,106
2024-10-29,14éûîº,397,135,262,212,0,47,91,19,26,0,212,186,135,262,212,0,47,91,19,26,0,212,186
2024-10-29,15éû,370,108,262,212,0,47,91,19,0,0,212,159,108,262,212,0,47,91,19,0,0,212,159
2024-10-29,15éûîº,323,61,262,212,0,0,91,19,0,0,212,111,61,262,212,0,0,91,19,0,0,212,111
2024-10-29,16éû,144,94,50,0,0,0,91,19,33,0,0,144,94,50,0,0,0,91,19,33,0,0,144
2024-10-29,16éûîº,255,205,50,111,0,0,91,19,33,0,0,256,205,50,111,0,0,91,19,33,0,0,256
2024-10-29,17éû,255,205,50,111,0,0,91,19,33,0,0,256,205,50,111,0,0,91,19,33,0,0,256
2024-10-29,17éûîº,166,116,50,0,0,0,81,53,33,0,0,167,116,50,0,0,0,81,53,33,0,0,167
2024-10-29,18éû,127,127,0,0,0,0,40,53,33,0,0,127,127,0,0,0,0,40,53,33,0,0,127
2024-10-29,18éûîº,101,101,0,0,0,0,14,53,33,0,0,101,101,0,0,0,0,14,53,33,0,0,101
2024-10-29,19éû,101,101,0,0,0,0,14,53,33,0,0,101,101,0,0,0,0,14,53,33,0,0,101
2024-10-29,19éûîº,155,155,0,0,0,54,14,53,33,0,54,101,155,0,0,0,54,14,53,33,0,54,101
2024-10-29,20éû,138,138,0,0,0,37,14,53,33,0,0,138,138,0,0,0,37,14,53,33,0,0,138
2024-10-29,20éûîº,90,90,0,0,0,37,0,19,33,0,0,90,90,0,0,0,37,0,19,33,0,0,90
2024-10-29,21éû,90,90,0,0,0,37,0,19,33,0,0,90,90,0,0,0,37,0,19,33,0,0,90
2024-10-29,21éûîº,321,90,231,231,0,37,0,19,33,0,0,321,90,231,231,0,37,0,19,33,0,0,321
2024-10-29,22éû,118,118,0,0,0,37,28,19,33,0,28,90,118,0,0,0,37,28,19,33,0,28,90
2024-10-29,22éûîº,118,118,0,0,0,37,28,19,33,0,28,90,118,0,0,0,37,28,19,33,0,28,90
2024-10-29,23éû,118,118,0,0,0,37,28,19,33,0,28,90,118,0,0,0,37,28,19,33,0,28,90
2024-10-29,23éûîº,85,85,0,0,0,37,28,19,0,0,28,57,85,0,0,0,37,28,19,0,0,28,57
2024-10-29,24éû,98,98,0,0,0,37,28,0,33,0,28,70,98,0,0,0,37,28,0,33,0,28,70
2024-10-29,24éûîº,61,61,0,0,0,0,28,0,33,0,28,33,61,0,0,0,0,28,0,33,0,28,33
2024-10-29,25éû,61,61,0,0,0,0,28,0,33,0,28,33,61,0,0,0,0,28,0,33,0,28,33
2024-10-29,25éûîº,61,61,0,0,0,0,28,0,33,0,28,33,61,0,0,0,0,28,0,33,0,28,33
2024-10-29,26éû,61,61,0,0,0,0,28,0,33,0,28,33,61,0,0,0,0,28,0,33,0,28,33
2024-10-29,26éûîº,61,61,0,0,0,0,28,0,33,0,28,33,61,0,0,0,0,28,0,33,0,28,33
2024-10-29,27éû,61,61,0,0,0,0,28,0,33,0,28,33,61,0,0,0,0,28,0,33,0,28,33
2024-10-29,27éûîº,61,61,0,0,0,0,28,0,33,0,28,33,61,0,0,0,0,28,0,33,0,28,33
2024-10-29,28éû,61,61,0,0,0,0,28,0,33,0,28,33,61,0,0,0,0,28,0,33,0,28,33
2024-10-29,28éûîº,61,61,0,0,0,0,28,0,33,0,28,33,61,0,0,0,0,28,0,33,0,28,33
2024-10-30,5éû,37,37,0,0,0,37,0,0,0,0,0,37,37,0,0,0,37,0,0,0,0,0,37
2024-10-30,5éûîº,37,37,0,0,0,37,0,0,0,0,0,37,37,0,0,0,37,0,0,0,0,0,37
2024-10-30,6éû,37,37,0,0,0,37,0,0,0,0,0,37,37,0,0,0,37,0,0,0,0,0,37
2024-10-30,6éûîº,37,37,0,0,0,37,0,0,0,0,0,37,37,0,0,0,37,0,0,0,0,0,37
2024-10-30,7éû,71,71,0,0,0,37,34,0,0,0,0,71,71,0,0,0,37,34,0,0,0,0,71
2024-10-30,7éûîº,37,37,0,0,0,37,0,0,0,0,0,37,37,0,0,0,37,0,0,0,0,0,37
2024-10-30,8éû,0,0,0,0,0,0,0,0,0,0,0,0,0,0,0,0,0,0,0,0,0,0,0
2024-10-30,8éûîº,273,61,212,212,0,0,29,0,31,0,212,61,61,212,212,0,0,29,0,31,0,212,61
2024-10-30,9éû,212,0,212,212,0,0,0,0,0,0,212,0,0,212,212,0,0,0,0,0,0,212,0
2024-10-30,9éûîº,212,0,212,212,0,0,0,0,0,0,212,0,0,212,212,0,0,0,0,0,0,212,0
2024-10-30,10éû,264,52,212,212,0,52,0,0,0,0,212,52,52,212,212,0,52,0,0,0,0,212,52
2024-10-30,10éûîº,212,0,212,212,0,0,0,0,0,0,212,0,0,212,212,0,0,0,0,0,0,212,0
2024-10-30,11éû,212,0,212,212,0,0,0,0,0,0,212,0,0,212,212,0,0,0,0,0,0,212,0
2024-10-30,11éûîº,212,0,212,212,0,0,0,0,0,0,212,0,0,212,212,0,0,0,0,0,0,212,0
2024-10-30,12éû,212,0,212,212,0,0,0,0,0,0,212,0,0,212,212,0,0,0,0,0,0,212,0
2024-10-30,12éûîº,733,37,696,696,0,0,0,0,37,0,212,522,37,696,696,0,0,0,0,37,0,212,522
2024-10-30,13éû,805,109,696,696,0,51,20,0,37,0,283,522,109,696,696,0,51,20,0,37,0,283,522
2024-10-30,13éûîº,835,139,696,696,0,51,50,0,37,0,283,552,139,696,696,0,51,50,0,37,0,283,552
2024-10-30,14éû,212,0,212,212,0,0,0,0,0,0,212,0,0,212,212,0,0,0,0,0,0,212,0
2024-10-30,14éûîº,212,0,212,212,0,0,0,0,0,0,212,0,0,212,212,0,0,0,0,0,0,212,0
2024-10-30,15éû,212,0,212,212,0,0,0,0,0,0,212,0,0,212,212,0,0,0,0,0,0,212,0
2024-10-30,15éûîº,212,0,212,212,0,0,0,0,0,0,212,0,0,212,212,0,0,0,0,0,0,212,0
2024-10-30,16éû,262,50,212,212,0,50,0,0,0,0,212,50,50,212,212,0,50,0,0,0,0,212,50
2024-10-30,16éûîº,0,0,0,0,0,0,0,0,0,0,0,0,0,0,0,0,0,0,0,0,0,0,0
2024-10-30,17éû,0,0,0,0,0,0,0,0,0,0,0,0,0,0,0,0,0,0,0,0,0,0,0
2024-10-30,17éûîº,29,29,0,0,0,0,29,0,0,0,0,29,29,0,0,0,0,29,0,0,0,0,29
2024-10-30,18éû,0,0,0,0,0,0,0,0,0,0,0,0,0,0,0,0,0,0,0,0,0,0,0
2024-10-30,18éûîº,0,0,0,0,0,0,0,0,0,0,0,0,0,0,0,0,0,0,0,0,0,0,0
2024-10-30,19éû,0,0,0,0,0,0,0,0,0,0,0,0,0,0,0,0,0,0,0,0,0,0,0
2024-10-30,19éûîº,0,0,0,0,0,0,0,0,0,0,0,0,0,0,0,0,0,0,0,0,0,0,0
2024-10-30,20éû,20,20,0,0,0,0,20,0,0,0,0,20,20,0,0,0,0,20,0,0,0,0,20
2024-10-30,20éûîº,89,89,0,0,0,49,20,19,0,0,0,89,89,0,0,0,49,20,19,0,0,0,89
2024-10-30,21éû,89,89,0,0,0,49,20,19,0,0,0,89,89,0,0,0,49,20,19,0,0,0,89
2024-10-30,21éûîº,89,89,0,0,0,49,20,19,0,0,0,89,89,0,0,0,49,20,19,0,0,0,89
2024-10-30,22éû,101,101,0,0,0,0,82,19,0,0,0,101,101,0,0,0,0,82,19,0,0,0,101
2024-10-30,22éûîº,101,101,0,0,0,0,82,19,0,0,0,101,101,0,0,0,0,82,19,0,0,0,101
2024-10-30,23éû,135,135,0,0,65,0,50,19,0,0,0,135,135,0,0,65,0,50,19,0,0,0,135
2024-10-30,23éûîº,135,135,0,0,65,0,50,19,0,0,0,135,135,0,0,65,0,50,19,0,0,0,135
2024-10-30,24éû,70,70,0,0,0,0,50,19,0,0,0,70,70,0,0,0,0,50,19,0,0,0,70
2024-10-30,24éûîº,70,70,0,0,0,0,50,19,0,0,0,70,70,0,0,0,0,50,19,0,0,0,70
2024-10-30,25éû,70,70,0,0,0,0,50,19,0,0,0,70,70,0,0,0,0,50,19,0,0,0,70
2024-10-30,25éûîº,70,70,0,0,0,0,50,19,0,0,0,70,70,0,0,0,0,50,19,0,0,0,70
2024-10-30,26éû,49,49,0,0,0,0,30,19,0,0,0,49,49,0,0,0,0,30,19,0,0,0,49
2024-10-30,26éûîº,49,49,0,0,0,0,30,19,0,0,0,49,49,0,0,0,0,30,19,0,0,0,49
2024-10-30,27éû,49,49,0,0,0,0,30,19,0,0,0,49,49,0,0,0,0,30,19,0,0,0,49
2024-10-30,27éûîº,49,49,0,0,0,0,30,19,0,0,0,49,49,0,0,0,0,30,19,0,0,0,49
2024-10-30,28éû,49,49,0,0,0,0,30,19,0,0,0,49,49,0,0,0,0,30,19,0,0,0,49
2024-10-30,28éûîº,49,49,0,0,0,0,30,19,0,0,0,49,49,0,0,0,0,30,19,0,0,0,49
